DOA,Risk Group,MAB-RTW,MAB,RTW,Total SL
11/2/2011,Low Risk,112,147,35,18
10/19/2011,Low Risk,125,174,49,11
11/2/2011,Low Risk,195,231,36,36
11/6/2011,Low Risk,196,241,45,45
10/3/2011,Low Risk,471,533,62,12
11/16/2011,High Risk,61,106,45,47
10/19/2011,Low Risk,163,211,48,36
10/5/2011,Low Risk,0,134,134,114
11/7/2011,High Risk,88,395,307,344
11/22/2011,High Risk,92,133,41,35
10/8/2011,Low Risk,314,318,4,4
11/22/2011,Low Risk,70,147,77,11
11/20/2011,Low Risk,122,165,43,43
10/29/2011,Low Risk,97,122,25,25
10/21/2011,Low Risk,117,236,119,13
10/28/2011,Low Risk,93,131,38,15
10/4/2011,High Risk,416,744,328,316
10/19/2011,Low Risk,109,147,38,38
10/12/2011,Low Risk,147,245,98,34
10/29/2011,Low Risk,190,258,68,68
11/25/2011,High Risk,136,193,57,55
11/24/2011,Low Risk,118,146,28,24
11/24/2011,Low Risk,132,160,28,9
11/20/2011,Low Risk,192,228,36,89
11/22/2011,Low Risk,100,169,69,44
10/15/2011,Low Risk,277,324,47,43
11/7/2011,Low Risk,140,177,37,37
11/22/2011,Low Risk,98,128,30,4
10/3/2011,Low Risk,151,170,19,19
11/18/2011,High Risk,85,229,144,143
11/1/2011,High Risk,955,1248,293,115
11/11/2011,Low Risk,128,172,44,43
11/12/2011,Low Risk,36,273,237,245
10/7/2011,Low Risk,0,228,228,28
10/1/2011,High Risk,71,201,130,120
11/1/2011,High Risk,183,442,259,248
11/14/2011,High Risk,121,219,98,93
11/28/2011,Low Risk,17,49,32,32
11/16/2011,Low Risk,82,118,36,7
11/21/2011,Low Risk,433,477,44,40
11/24/2011,Low Risk,111,153,42,7
8/18/2011,High Risk,-218,265,483,468
12/2/2011,Low Risk,145,154,9,9
11/29/2011,High Risk,250,240,-10,75
11/29/2011,Low Risk,467,638,171,171
12/4/2011,Low Risk,103,121,18,18
11/26/2011,Low Risk,128,160,32,32
11/14/2011,Low Risk,11,46,35,10
11/16/2011,Low Risk,118,182,64,25
11/23/2011,Low Risk,120,147,27,8
11/30/2011,High Risk,64,245,181,141
11/17/2011,Low Risk,105,160,55,55
12/3/2011,Low Risk,50,117,67,4
11/22/2011,High Risk,267,471,204,187
11/30/2011,Low Risk,264,288,24,20
11/25/2011,Low Risk,120,165,45,13
12/6/2011,Low Risk,101,176,75,75
10/19/2011,Low Risk,79,154,75,75
11/24/2011,Low Risk,184,217,33,33
11/17/2011,Low Risk,92,237,145,12
10/12/2011,Low Risk,40,50,10,10
11/7/2011,Low Risk,51,86,35,35
12/7/2011,Low Risk,321,337,16,16
11/20/2011,Low Risk,146,191,45,7
12/10/2011,Low Risk,356,415,59,16
10/24/2011,Low Risk,-82,326,408,51
11/25/2011,Low Risk,106,152,46,15
12/6/2011,Low Risk,103,132,29,8
12/12/2011,Low Risk,205,343,138,138
12/7/2011,Low Risk,114,163,49,49
11/29/2011,Low Risk,145,161,16,16
12/11/2011,Low Risk,123,163,40,40
12/12/2011,Low Risk,246,339,93,20
12/15/2011,Low Risk,165,174,9,9
12/12/2011,High Risk,234,378,144,120
12/13/2011,Low Risk,173,217,44,35
10/3/2011,Low Risk,498,514,16,16
11/3/2011,Low Risk,160,189,29,29
10/24/2011,Low Risk,284,302,18,18
10/24/2011,Low Risk,168,177,9,9
12/2/2011,Low Risk,152,193,41,40
11/28/2011,Low Risk,124,135,11,11
11/18/2011,Low Risk,192,202,10,10
11/14/2011,Low Risk,69,80,11,11
11/21/2011,Low Risk,131,143,12,12
12/20/2011,Low Risk,237,248,11,11
8/22/2011,Low Risk,205,233,28,28
11/6/2011,High Risk,221,338,117,33
11/6/2011,Low Risk,190,197,7,7
12/22/2011,High Risk,199,424,225,250
10/29/2011,Low Risk,77,179,102,35
11/27/2011,Legal Case,2,381,379,300
12/21/2011,Low Risk,125,139,14,14
12/8/2011,Low Risk,100,161,61,61
12/10/2011,Low Risk,189,223,34,12
12/31/2011,Low Risk,0,45,45,12
12/25/2011,Low Risk,119,155,36,5
11/16/2011,Low Risk,35,93,58,7
1/4/2012,Low Risk,133,141,8,8
11/10/2011,Low Risk,85,166,81,33
12/21/2011,Low Risk,112,139,27,27
12/16/2011,Low Risk,152,180,28,28
11/27/2011,Low Risk,2,81,79,8
12/30/2011,Low Risk,135,167,32,28
1/9/2012,High Risk,162,260,98,94
1/5/2012,Low Risk,187,210,23,23
12/3/2011,Low Risk,155,249,94,94
12/2/2011,Low Risk,43,98,55,13
12/15/2011,Low Risk,147,189,42,12
11/6/2011,Low Risk,89,108,19,19
1/17/2012,Low Risk,175,198,23,6
11/9/2011,Low Risk,130,273,143,143
11/23/2011,Low Risk,-57,196,253,12
12/9/2011,Low Risk,259,279,20,20
1/2/2012,Low Risk,102,137,35,7
1/11/2012,Legal Case,267,576,309,116
11/3/2011,Low Risk,121,216,95,4
12/23/2011,Low Risk,221,262,41,10
1/3/2012,Low Risk,54,83,29,29
1/14/2012,High Risk,26,438,412,421
1/14/2012,Low Risk,71,143,72,52
12/12/2011,Low Risk,225,234,9,9
1/3/2012,High Risk,582,610,28,354
12/23/2011,Low Risk,143,224,81,14
1/4/2012,Low Risk,6,182,176,176
1/6/2012,Legal Case,180,202,22,16
1/4/2012,Low Risk,200,246,46,110
1/1/2012,Low Risk,166,239,73,22
1/19/2012,High Risk,254,427,173,180
1/6/2012,Low Risk,183,228,45,14
12/20/2011,Low Risk,56,135,79,14
12/25/2011,Low Risk,123,197,74,10
1/14/2012,Low Risk,204,242,38,36
1/20/2012,Low Risk,142,154,12,12
1/9/2012,Low Risk,0,45,45,10
12/10/2011,Low Risk,0,345,345,13
12/1/2011,Low Risk,-231,112,343,28
12/16/2011,Low Risk,162,306,144,87
1/20/2012,Low Risk,12,21,9,9
1/28/2012,Low Risk,0,13,13,13
1/26/2012,Low Risk,-24,15,39,7
1/4/2012,Low Risk,626,673,47,14
2/2/2012,Low Risk,22,195,173,72
1/8/2012,Low Risk,142,185,43,20
12/17/2011,Low Risk,117,130,13,13
12/21/2011,High Risk,-182,1009,1191,705
1/9/2012,High Risk,55,213,158,159
1/27/2012,Low Risk,137,153,16,16
12/1/2011,High Risk,0,363,363,140
1/10/2012,Low Risk,0,45,45,13
2/6/2012,High Risk,152,198,46,49
1/4/2012,Low Risk,407,429,22,22
2/3/2012,Low Risk,36,52,16,16
1/31/2012,Low Risk,132,163,31,32
2/11/2012,Low Risk,0,13,13,7
11/5/2011,Low Risk,109,163,54,54
2/16/2012,High Risk,91,259,168,159
2/3/2012,Low Risk,232,279,47,47
1/15/2012,Low Risk,0,38,38,24
1/5/2012,Low Risk,0,49,49,25
1/3/2012,Low Risk,0,50,50,15
1/4/2012,High Risk,-19,145,164,154
1/5/2012,Low Risk,0,48,48,15
2/2/2012,Low Risk,0,20,20,4
2/8/2012,Low Risk,0,14,14,5
12/9/2011,Low Risk,127,132,5,5
12/2/2011,High Risk,50,286,236,201
12/15/2011,Low Risk,139,153,14,14
1/16/2012,Low Risk,167,178,11,11
11/7/2011,Low Risk,566,589,23,23
10/13/2011,Low Risk,214,223,9,9
9/4/2011,Low Risk,259,283,24,24
11/13/2011,Low Risk,145,178,33,33
2/4/2012,High Risk,472,509,37,131
2/15/2012,Low Risk,88,111,23,15
2/13/2012,Low Risk,108,133,25,6
1/21/2012,Low Risk,195,242,47,47
2/26/2012,Low Risk,604,689,85,105
1/14/2012,Low Risk,474,506,32,32
10/26/2011,High Risk,520,616,96,114
11/14/2011,Low Risk,258,305,47,47
10/17/2011,Low Risk,78,121,43,8
1/21/2012,Low Risk,136,164,28,28
11/8/2011,High Risk,291,573,282,270
2/3/2012,Low Risk,118,153,35,4
2/14/2012,Low Risk,0,24,24,7
2/17/2012,Low Risk,0,21,21,5
2/13/2012,Low Risk,105,130,25,8
2/9/2012,Low Risk,105,134,29,7
2/1/2012,Low Risk,33,70,37,14
2/6/2012,Low Risk,117,149,32,10
2/13/2012,High Risk,170,254,84,83
9/24/2011,Low Risk,180,227,47,47
1/2/2012,Low Risk,65,380,315,14
1/13/2012,High Risk,-27,202,229,107
2/18/2012,Low Risk,0,20,20,4
2/21/2012,High Risk,230,323,93,91
2/18/2012,Low Risk,112,143,31,16
11/17/2011,Low Risk,281,398,117,6
12/19/2011,Low Risk,36,325,289,48
2/7/2012,High Risk,1,232,231,148
2/21/2012,High Risk,430,542,112,145
2/21/2012,Low Risk,217,283,66,14
1/25/2012,High Risk,189,630,441,245
1/31/2012,Low Risk,141,150,9,9
2/6/2012,Low Risk,125,143,18,18
2/2/2012,Low Risk,122,147,25,25
1/11/2012,Low Risk,167,181,14,14
12/25/2011,High Risk,821,1319,498,86
12/31/2011,Low Risk,180,188,8,8
1/18/2012,Low Risk,92,287,195,6
1/5/2012,Low Risk,93,104,11,11
12/2/2011,Low Risk,126,195,69,69
1/1/2012,Low Risk,172,334,162,157
2/23/2012,Low Risk,107,141,34,11
3/9/2012,Low Risk,17,161,144,14
1/4/2012,Low Risk,121,196,75,75
2/20/2012,Low Risk,267,296,29,9
1/19/2012,Low Risk,295,350,55,13
2/23/2012,Low Risk,147,173,26,20
2/10/2012,Low Risk,274,313,39,14
2/29/2012,Low Risk,140,155,15,32
9/30/2011,Low Risk,110,140,30,30
10/8/2011,Low Risk,119,130,11,11
12/23/2011,Low Risk,110,194,84,15
3/2/2012,High Risk,163,257,94,90
2/21/2012,Low Risk,98,227,129,70
2/15/2012,Low Risk,6,43,37,8
3/1/2012,Low Risk,2,140,138,25
1/31/2012,Low Risk,28,45,17,17
10/12/2011,Low Risk,149,156,7,7
1/25/2012,Low Risk,251,265,14,14
2/9/2012,Low Risk,109,119,10,10
2/13/2012,Low Risk,129,143,14,14
2/25/2012,Low Risk,140,152,12,12
1/16/2012,Low Risk,57,94,37,9
1/19/2012,Low Risk,0,60,60,13
2/27/2012,Low Risk,98,171,73,73
2/22/2012,Low Risk,145,156,11,11
2/26/2012,Low Risk,100,157,57,27
2/14/2012,Low Risk,102,154,52,41
2/21/2012,Low Risk,116,147,31,8
3/4/2012,Low Risk,0,78,78,10
3/3/2012,Low Risk,75,123,48,18
3/9/2012,High Risk,112,621,509,479
3/19/2012,Low Risk,225,269,44,31
1/21/2012,Low Risk,191,241,50,40
3/3/2012,Low Risk,148,194,46,15
3/4/2012,Low Risk,79,106,27,27
2/14/2012,Low Risk,250,281,31,31
4/14/2011,Low Risk,376,391,15,15
2/18/2012,Low Risk,133,151,18,18
3/6/2012,Low Risk,125,134,9,9
2/23/2012,Low Risk,279,363,84,58
2/29/2012,Low Risk,78,119,41,41
12/7/2011,Low Risk,204,224,20,20
2/26/2012,Low Risk,96,128,32,32
2/29/2012,High Risk,175,265,90,62
3/9/2012,Low Risk,51,119,68,24
3/6/2012,Low Risk,119,157,38,12
2/19/2012,Low Risk,109,152,43,16
3/5/2012,High Risk,147,353,206,108
3/9/2012,High Risk,49,203,154,99
5/3/2011,Low Risk,333,379,46,55
11/20/2011,Low Risk,140,198,58,55
3/4/2012,Low Risk,546,570,24,24
12/14/2011,Low Risk,163,174,11,11
1/23/2012,High Risk,92,177,85,74
1/17/2012,Low Risk,53,112,59,10
3/15/2012,Low Risk,344,370,26,26
3/7/2012,Low Risk,-220,19,239,239
3/6/2012,Low Risk,89,107,18,18
2/25/2012,Low Risk,77,235,158,146
2/28/2012,High Risk,294,343,49,184
2/20/2012,High Risk,134,373,239,233
3/4/2012,High Risk,150,389,239,226
3/16/2012,Low Risk,44,193,149,149
11/3/2011,Low Risk,202,245,43,43
3/7/2012,Low Risk,123,134,11,11
3/5/2012,Low Risk,0,249,249,30
3/6/2012,Low Risk,202,211,9,9
3/10/2012,Low Risk,101,150,49,49
3/11/2012,Low Risk,82,122,40,11
2/2/2012,High Risk,107,345,238,162
1/17/2012,Low Risk,135,150,15,15
11/30/2011,Low Risk,339,343,4,4
2/25/2012,Low Risk,165,173,8,8
3/5/2012,Low Risk,254,283,29,29
3/2/2012,Low Risk,90,152,62,5
12/14/2011,Low Risk,185,308,123,123
2/27/2012,Low Risk,87,95,8,8
3/20/2012,High Risk,165,367,202,138
3/25/2012,High Risk,120,207,87,85
1/17/2012,Low Risk,665,674,9,9
3/26/2012,Low Risk,78,134,56,17
3/11/2012,Low Risk,104,114,10,10
3/12/2012,Low Risk,0,70,70,19
4/10/2012,High Risk,266,275,9,106
3/17/2012,Legal Case,21,698,677,301
3/22/2012,Low Risk,319,363,44,44
3/23/2012,High Risk,362,397,35,101
3/10/2012,Low Risk,252,348,96,16
1/3/2012,High Risk,91,217,126,121
3/29/2012,Low Risk,162,167,5,32
3/5/2012,Low Risk,116,128,12,12
3/24/2012,Low Risk,0,32,32,20
2/18/2012,Low Risk,123,216,93,63
3/8/2012,Low Risk,108,127,19,19
3/12/2012,Low Risk,214,227,13,13
3/19/2012,High Risk,-105,360,465,68
2/10/2012,Low Risk,221,250,29,29
3/25/2012,Low Risk,242,264,22,22
3/20/2012,Low Risk,0,136,136,29
4/7/2012,Low Risk,79,131,52,26
4/3/2012,Low Risk,0,30,30,7
3/19/2012,Low Risk,199,211,12,12
2/2/2012,Low Risk,252,260,8,8
2/28/2012,Low Risk,155,197,42,42
4/16/2012,Low Risk,79,116,37,37
4/2/2012,Low Risk,95,122,27,27
4/5/2012,Low Risk,222,244,22,22
3/27/2012,High Risk,158,434,276,257
4/2/2012,High Risk,93,130,37,35
3/13/2012,Low Risk,0,118,118,14
4/6/2012,High Risk,99,223,124,121
4/30/2012,Low Risk,58,150,92,21
3/31/2012,Low Risk,286,363,77,77
4/4/2012,Low Risk,91,100,9,9
4/23/2012,Low Risk,141,150,9,9
4/16/2012,Low Risk,113,213,100,100
2/26/2012,Low Risk,3,82,79,18
4/3/2012,High Risk,148,307,159,173
4/20/2012,High Risk,114,152,38,37
4/20/2012,High Risk,546,573,27,114
4/13/2012,Low Risk,148,180,32,8
4/20/2012,Low Risk,182,207,25,4
4/7/2012,Low Risk,104,142,38,10
5/13/2012,Low Risk,217,225,8,8
4/15/2012,Low Risk,119,150,31,9
3/16/2012,Low Risk,101,111,10,10
3/26/2012,Low Risk,134,200,66,26
4/17/2012,High Risk,78,247,169,87
2/10/2012,Low Risk,118,215,97,11
4/28/2012,Low Risk,47,115,68,17
4/10/2012,Low Risk,298,372,74,74
2/6/2012,Low Risk,137,155,18,18
5/9/2012,Low Risk,52,100,48,47
5/11/2012,Legal Case,97,131,34,42
5/10/2012,Low Risk,82,117,35,15
5/8/2012,High Risk,97,177,80,78
5/8/2012,Low Risk,98,121,23,14
4/10/2012,High Risk,66,248,182,127
1/10/2012,Low Risk,83,147,64,20
5/1/2012,Low Risk,196,225,29,9
2/5/2012,Low Risk,260,347,87,88
1/19/2012,Low Risk,206,243,37,37
3/7/2012,Low Risk,56,169,113,16
4/26/2012,Low Risk,148,188,40,40
4/20/2012,Low Risk,104,146,42,42
4/28/2012,Low Risk,15,26,11,11
4/23/2012,Low Risk,19,50,31,12
5/12/2012,Low Risk,112,130,18,18
4/19/2012,High Risk,400,454,54,49
4/27/2012,High Risk,-1,355,356,303
4/16/2012,Low Risk,177,275,98,4
5/2/2012,Low Risk,115,204,89,37
5/16/2012,Low Risk,64,126,62,20
2/20/2012,Low Risk,170,183,13,13
4/25/2012,Low Risk,158,169,11,11
5/15/2012,High Risk,44,147,103,36
2/21/2012,High Risk,734,1182,448,350
2/5/2012,Low Risk,106,136,30,30
2/18/2012,Low Risk,112,123,11,11
4/3/2012,Low Risk,177,198,21,21
4/25/2012,Low Risk,117,132,15,15
5/15/2012,Low Risk,361,372,11,11
5/20/2012,High Risk,73,171,98,45
5/9/2012,Low Risk,139,175,36,26
2/22/2012,High Risk,296,406,110,257
5/16/2012,Low Risk,441,467,26,18
4/16/2012,Low Risk,108,164,56,25
5/9/2012,Low Risk,108,141,33,14
4/6/2012,Low Risk,45,160,115,15
5/4/2012,High Risk,155,161,6,34
5/17/2012,High Risk,21,111,90,102
5/18/2012,High Risk,98,153,55,45
5/23/2012,High Risk,93,210,117,115
5/22/2012,Low Risk,43,112,69,4
4/3/2012,Low Risk,115,140,25,25
5/15/2012,Low Risk,0,65,65,10
5/29/2012,Low Risk,104,142,38,31
4/19/2012,High Risk,118,158,40,45
5/28/2012,High Risk,83,205,122,38
4/23/2012,Low Risk,111,163,52,26
10/20/2011,Low Risk,1037,1041,4,4
3/25/2012,Low Risk,96,117,21,21
5/13/2012,Low Risk,82,95,13,13
5/25/2012,High Risk,100,145,45,43
3/30/2012,Low Risk,127,158,31,31
5/22/2012,Low Risk,104,127,23,23
3/31/2012,Low Risk,100,111,11,11
5/27/2012,Low Risk,47,129,82,30
4/22/2012,Low Risk,29,179,150,51
5/18/2012,Low Risk,100,108,8,8
4/22/2012,Low Risk,-21,52,73,15
4/9/2012,Low Risk,102,120,18,18
4/7/2012,Low Risk,421,440,19,124
5/24/2012,Low Risk,128,195,67,9
5/20/2012,High Risk,92,177,85,155
5/26/2012,Low Risk,115,146,31,14
6/5/2012,Low Risk,11,202,191,10
5/25/2012,Low Risk,21,42,21,15
5/24/2012,Low Risk,24,46,22,7
6/10/2012,Low Risk,91,116,25,25
5/8/2012,Low Risk,98,121,23,23
2/3/2012,High Risk,331,762,431,462
5/16/2012,High Risk,169,239,70,114
4/29/2012,Low Risk,202,219,17,17
5/25/2012,High Risk,452,486,34,136
5/18/2012,Low Risk,72,112,40,40
6/9/2012,High Risk,-29,305,334,225
6/11/2012,Low Risk,131,155,24,6
4/11/2012,High Risk,103,246,143,241
6/1/2012,Low Risk,124,159,35,6
4/21/2012,Low Risk,81,179,98,95
5/21/2012,Low Risk,87,198,111,111
5/30/2012,Low Risk,129,140,11,11
6/14/2012,Low Risk,0,21,21,5
6/19/2012,Low Risk,120,136,16,14
5/25/2012,Low Risk,125,202,77,10
6/6/2012,Low Risk,252,279,27,27
6/13/2012,Low Risk,140,176,36,17
5/22/2012,Low Risk,295,364,69,23
4/30/2012,Low Risk,137,197,60,60
6/14/2012,Low Risk,0,25,25,8
6/5/2012,High Risk,-170,-89,81,77
6/4/2012,Low Risk,58,165,107,7
5/17/2012,High Risk,-2,321,323,284
5/24/2012,High Risk,84,350,266,240
5/28/2012,High Risk,43,165,122,125
5/30/2012,High Risk,62,334,272,323
6/5/2012,Low Risk,496,520,24,24
12/6/2011,Low Risk,189,206,17,17
6/16/2012,Low Risk,144,185,41,41
1/2/2012,Low Risk,126,156,30,30
2/7/2012,Low Risk,259,274,15,15
6/14/2012,Low Risk,132,153,21,12
6/20/2012,Low Risk,188,196,8,8
6/21/2012,Low Risk,139,153,14,9
5/3/2012,Low Risk,775,799,24,24
5/17/2012,Low Risk,109,125,16,16
6/21/2012,Low Risk,92,113,21,19
5/23/2012,Low Risk,120,170,50,6
5/31/2012,Low Risk,139,151,12,12
6/5/2012,High Risk,828,1136,308,463
4/27/2012,Low Risk,117,201,84,9
6/18/2012,Low Risk,125,141,16,16
5/18/2012,Low Risk,152,160,8,8
5/24/2012,Low Risk,186,204,18,18
5/29/2012,High Risk,488,652,164,200
5/12/2012,Low Risk,148,171,23,23
6/4/2012,Low Risk,90,163,73,12
6/23/2012,Low Risk,26,115,89,7
5/29/2012,Low Risk,106,149,43,41
4/28/2012,Low Risk,188,226,38,38
6/9/2012,Low Risk,-222,-133,89,89
2/26/2012,Low Risk,112,143,31,31
6/30/2012,Low Risk,127,164,37,11
10/27/2011,Low Risk,374,391,17,17
5/8/2012,High Risk,146,219,73,66
5/27/2012,Low Risk,190,236,46,9
6/8/2012,Low Risk,405,467,62,62
6/27/2012,Low Risk,92,132,40,39
6/12/2012,Low Risk,123,143,20,20
6/27/2012,Low Risk,49,99,50,29
5/25/2012,Low Risk,64,102,38,38
6/22/2012,Low Risk,146,312,166,166
6/21/2012,Low Risk,142,174,32,7
6/21/2012,Low Risk,118,146,28,7
6/12/2012,High Risk,278,741,463,198
7/6/2012,Low Risk,138,237,99,96
5/4/2012,Low Risk,88,98,10,10
6/18/2012,High Risk,157,269,112,120
3/6/2012,Low Risk,190,225,35,35
5/7/2012,Low Risk,118,126,8,8
6/4/2012,Low Risk,137,185,48,51
5/10/2012,Low Risk,99,188,89,89
5/24/2012,Low Risk,153,251,98,98
5/27/2012,Low Risk,148,158,10,10
6/29/2012,Low Risk,197,206,9,9
6/23/2012,Low Risk,115,144,29,29
6/26/2012,Low Risk,0,69,69,12
7/9/2012,Low Risk,109,126,17,8
5/28/2012,High Risk,133,403,270,262
5/30/2012,Low Risk,270,308,38,38
5/31/2012,High Risk,227,714,487,160
6/1/2012,Low Risk,272,280,8,8
4/9/2012,Low Risk,1035,1213,178,178
7/13/2012,Low Risk,161,174,13,8
6/5/2012,Low Risk,305,525,220,220
3/16/2012,Low Risk,-157,-72,85,85
6/15/2012,Low Risk,54,279,225,225
6/6/2012,Low Risk,124,141,17,17
2/28/2012,Low Risk,471,555,84,84
6/14/2012,Low Risk,26,629,603,27
7/15/2012,Low Risk,313,185,-128,46
6/25/2012,Low Risk,122,137,15,15
5/29/2012,Low Risk,110,142,32,32
5/30/2012,Low Risk,303,322,19,19
4/30/2012,Low Risk,128,150,22,22
5/21/2012,Low Risk,177,184,7,7
7/6/2012,Low Risk,124,133,9,9
6/18/2012,Low Risk,229,247,18,18
6/15/2012,High Risk,428,629,201,129
7/6/2012,High Risk,-43,649,692,172
6/1/2012,High Risk,75,362,287,323
6/29/2012,High Risk,158,285,127,123
7/10/2012,Low Risk,0,79,79,13
6/18/2012,Low Risk,124,137,13,13
6/21/2012,Low Risk,89,133,44,44
7/5/2012,Low Risk,213,230,17,17
6/20/2012,Low Risk,144,280,136,102
6/13/2012,Low Risk,1,149,148,148
7/16/2012,Low Risk,72,114,42,42
7/25/2012,Low Risk,164,240,76,76
6/22/2012,High Risk,319,367,48,28
6/16/2012,High Risk,79,194,115,84
7/13/2012,Low Risk,412,439,27,59
7/8/2012,Low Risk,179,222,43,18
7/27/2012,Low Risk,200,238,38,38
6/30/2012,Low Risk,129,181,52,40
7/23/2012,Low Risk,91,142,51,50
7/20/2012,Low Risk,123,144,21,13
7/6/2012,Low Risk,112,158,46,7
7/4/2012,Low Risk,250,294,44,16
7/5/2012,Low Risk,147,189,42,30
7/19/2012,Low Risk,211,238,27,27
6/29/2012,Legal Case,139,712,573,490
7/1/2012,Low Risk,200,247,47,19
5/5/2012,Low Risk,211,370,159,159
5/28/2012,Low Risk,299,315,16,16
7/20/2012,Low Risk,52,76,24,15
7/13/2012,High Risk,35,159,124,86
7/17/2012,Low Risk,297,339,42,42
6/12/2012,High Risk,162,212,50,17
7/11/2012,Low Risk,203,239,36,21
7/25/2012,Low Risk,82,108,26,23
7/31/2012,High Risk,46,167,121,117
5/16/2012,High Risk,289,764,475,422
7/31/2012,Low Risk,130,150,20,7
8/2/2012,Low Risk,212,231,19,14
7/17/2012,High Risk,46,129,83,70
6/1/2012,Low Risk,258,279,21,21
6/22/2012,Low Risk,216,249,33,33
7/15/2012,Low Risk,111,122,11,11
7/10/2012,Low Risk,116,129,13,13
7/23/2012,Low Risk,113,183,70,70
7/31/2012,High Risk,179,393,214,278
7/21/2012,Low Risk,198,209,11,11
7/13/2012,Low Risk,121,202,81,81
5/11/2012,Low Risk,330,514,184,184
6/5/2012,Low Risk,0,114,114,18
6/29/2012,Low Risk,117,139,22,22
3/16/2012,Low Risk,153,234,81,81
7/1/2012,Low Risk,-215,-151,64,64
7/14/2012,Low Risk,470,494,24,24
7/12/2012,Low Risk,75,155,80,80
7/6/2012,Low Risk,26,145,119,13
6/2/2012,Low Risk,106,152,46,46
6/27/2012,High Risk,480,499,19,142
2/26/2012,Low Risk,560,590,30,30
5/22/2012,Low Risk,132,169,37,37
3/25/2012,High Risk,433,801,368,338
7/31/2012,Low Risk,71,129,58,57
7/16/2012,Low Risk,180,227,47,47
7/1/2012,Low Risk,157,248,91,119
7/22/2012,Low Risk,305,353,48,48
6/27/2012,Low Risk,286,406,120,20
8/14/2012,Low Risk,157,205,48,48
6/8/2012,Low Risk,341,376,35,35
6/23/2012,Low Risk,181,193,12,12
6/30/2012,Low Risk,186,193,7,7
7/9/2012,Low Risk,406,476,70,70
7/15/2012,Low Risk,183,193,10,10
7/24/2012,Low Risk,0,63,63,19
7/31/2012,Low Risk,16,27,11,11
8/6/2012,Low Risk,13,21,8,8
8/1/2012,Low Risk,170,218,48,47
7/24/2012,Low Risk,203,465,262,262
7/26/2012,Low Risk,-18,17,35,35
8/8/2012,Low Risk,118,126,8,8
5/10/2012,Low Risk,436,540,104,104
3/28/2012,Low Risk,592,608,16,16
7/17/2012,Low Risk,82,141,59,67
8/16/2012,Low Risk,68,313,245,80
7/28/2012,Low Risk,53,102,49,49
7/14/2012,Low Risk,180,277,97,15
8/15/2012,Low Risk,147,174,27,10
8/16/2012,Low Risk,142,168,26,14
8/15/2012,Low Risk,248,308,60,60
6/7/2012,Low Risk,144,288,144,40
7/9/2012,Low Risk,157,366,209,209
8/20/2012,Low Risk,111,149,38,16
7/25/2012,Low Risk,284,772,488,36
5/22/2012,Low Risk,238,289,51,51
6/14/2012,Low Risk,68,124,56,77
3/18/2012,Legal Case,19,514,495,396
7/24/2012,Low Risk,227,325,98,98
7/3/2012,Low Risk,233,302,69,69
8/25/2012,Low Risk,146,192,46,46
8/9/2012,Low Risk,401,463,62,29
7/1/2012,Low Risk,266,304,38,38
7/7/2012,Low Risk,139,234,95,95
7/18/2012,Low Risk,107,148,41,38
7/6/2012,Low Risk,86,165,79,79
7/31/2012,Low Risk,373,492,119,119
6/17/2012,Low Risk,622,708,86,20
9/1/2012,High Risk,110,186,76,73
8/14/2012,Low Risk,0,44,44,19
8/9/2012,Low Risk,160,377,217,112
8/13/2012,Low Risk,203,252,49,49
8/1/2012,Low Risk,125,316,191,146
8/7/2012,Low Risk,424,476,52,41
8/8/2012,High Risk,44,322,278,238
8/27/2012,Low Risk,231,353,122,122
8/13/2012,Low Risk,5,107,102,102
8/8/2012,High Risk,102,363,261,213
8/27/2012,Low Risk,464,528,64,18
9/7/2012,Low Risk,55,97,42,17
8/10/2012,Low Risk,113,154,41,134
7/11/2012,Low Risk,22,63,41,41
7/9/2012,Low Risk,75,157,82,82
9/13/2012,Low Risk,52,117,65,61
8/26/2012,High Risk,372,418,46,43
9/13/2012,High Risk,-252,-178,74,71
8/25/2012,Low Risk,208,300,92,92
7/10/2012,High Risk,59,296,237,158
7/12/2012,Low Risk,-226,-161,65,65
7/18/2012,Low Risk,262,272,10,10
4/25/2012,Low Risk,232,247,15,15
4/26/2012,Low Risk,156,160,4,4
5/20/2012,Low Risk,108,136,28,28
6/30/2012,Low Risk,108,118,10,10
7/4/2012,Low Risk,181,190,9,9
7/27/2012,Low Risk,172,182,10,10
8/5/2012,High Risk,-257,-172,85,36
8/15/2012,Low Risk,587,604,17,17
8/21/2012,Low Risk,719,734,15,15
8/27/2012,High Risk,84,374,290,246
7/13/2012,Low Risk,455,460,5,5
8/1/2012,Low Risk,63,104,41,41
9/10/2012,High Risk,24,74,50,74
9/8/2012,Low Risk,0,59,59,7
7/28/2012,High Risk,255,531,276,130
9/3/2012,Low Risk,61,102,41,41
9/9/2012,High Risk,47,157,110,321
8/20/2012,Low Risk,325,388,63,61
9/8/2012,Low Risk,245,339,94,78
9/11/2012,High Risk,-40,463,503,283
8/15/2012,Low Risk,57,125,68,21
8/25/2012,Low Risk,72,93,21,21
9/18/2012,Low Risk,285,321,36,36
9/9/2012,Low Risk,46,99,53,26
10/2/2012,High Risk,119,336,217,54
5/18/2012,High Risk,441,727,286,332
9/30/2012,Low Risk,19,164,145,9
9/24/2012,High Risk,0,270,270,170
9/29/2012,High Risk,35,159,124,75
8/7/2012,Low Risk,-195,-156,39,39
10/8/2012,Low Risk,0,23,23,5
10/3/2012,Low Risk,0,28,28,4
8/24/2012,Low Risk,0,68,68,7
9/9/2012,Low Risk,128,180,52,11
10/3/2012,Low Risk,0,28,28,30
9/16/2012,High Risk,302,338,36,32
9/26/2012,Legal Case,79,268,189,171
6/16/2012,Legal Case,70,369,299,141
9/10/2012,High Risk,56,325,269,231
9/6/2012,High Risk,618,839,221,89
9/5/2012,Low Risk,163,183,20,20
10/10/2012,Low Risk,383,412,29,29
10/17/2012,High Risk,152,273,121,67
9/28/2012,Low Risk,74,110,36,36
9/11/2012,Low Risk,244,316,72,37
8/24/2012,Low Risk,112,139,27,27
8/28/2012,Low Risk,559,568,9,9
8/24/2012,Low Risk,218,225,7,7
10/7/2012,Low Risk,92,148,56,56
9/4/2012,High Risk,54,818,764,428
5/18/2012,Low Risk,0,168,168,23
8/26/2012,Low Risk,129,190,61,36
9/7/2012,Low Risk,120,178,58,58
8/16/2012,Low Risk,81,217,136,136
10/7/2012,Low Risk,122,138,16,16
10/1/2012,Low Risk,-28,35,63,63
10/12/2012,Low Risk,0,26,26,12
9/21/2012,Low Risk,162,209,47,43
9/18/2012,Low Risk,0,84,84,7
10/13/2012,Low Risk,145,208,63,63
10/12/2012,Low Risk,216,228,12,12
8/15/2012,Low Risk,112,119,7,7
10/9/2012,Low Risk,46,139,93,93
10/22/2012,Low Risk,97,192,95,95
9/30/2012,Low Risk,72,79,7,7
8/24/2012,Low Risk,67,77,10,10
9/18/2012,Low Risk,147,170,23,23
9/27/2012,Low Risk,535,552,17,17
10/26/2012,Low Risk,171,423,252,5
10/20/2012,Low Risk,106,165,59,59
10/24/2012,Low Risk,276,302,26,26
10/11/2012,Low Risk,498,538,40,15
10/18/2012,Low Risk,91,145,54,30
10/11/2012,Low Risk,161,196,35,35
8/17/2012,Low Risk,56,90,34,34
5/31/2012,High Risk,1,442,441,58
10/13/2012,Low Risk,13,52,39,9
10/13/2012,High Risk,191,229,38,246
10/12/2012,High Risk,141,377,236,268
10/18/2012,Low Risk,47,272,225,218
10/20/2012,Low Risk,56,181,125,10
10/18/2012,Low Risk,76,203,127,8
10/1/2012,Low Risk,327,373,46,46
11/11/2012,Low Risk,120,164,44,44
11/5/2012,Low Risk,84,128,44,44
11/14/2012,Low Risk,127,232,105,30
11/6/2012,High Risk,122,128,6,166
8/24/2012,Low Risk,122,159,37,37
10/4/2012,Low Risk,135,153,18,18
10/9/2012,Low Risk,121,150,29,29
11/6/2012,High Risk,90,281,191,246
11/9/2012,Low Risk,106,118,12,12
11/21/2012,High Risk,-1,379,380,325
10/22/2012,High Risk,0,240,240,102
11/20/2012,Low Risk,0,17,17,5
11/1/2012,Low Risk,263,302,39,20
10/31/2012,Low Risk,368,428,60,60
10/15/2012,Low Risk,0,359,359,27
11/10/2012,High Risk,391,513,122,43
11/19/2012,Low Risk,0,95,95,23
11/6/2012,Low Risk,65,111,46,46
10/26/2012,Low Risk,0,122,122,30
10/3/2012,Low Risk,168,232,64,145
11/2/2012,Low Risk,120,203,83,83
10/27/2012,Low Risk,256,338,82,30
11/6/2012,High Risk,338,633,295,239
11/13/2012,Low Risk,91,148,57,20
11/15/2012,High Risk,94,242,148,130
7/4/2012,Low Risk,209,232,23,23
8/3/2012,Low Risk,135,159,24,24
11/21/2012,Low Risk,86,161,75,78
10/11/2012,Low Risk,135,153,18,18
11/1/2012,Low Risk,0,116,116,26
11/23/2012,High Risk,107,215,108,93
10/29/2012,High Risk,60,228,168,139
12/8/2012,High Risk,7,170,163,60
11/21/2012,Low Risk,0,33,33,4
11/19/2012,Low Risk,0,46,46,4
9/21/2012,Low Risk,0,105,105,4
11/17/2012,High Risk,485,536,51,78
11/14/2012,Low Risk,157,194,37,10
8/3/2012,High Risk,148,383,235,94
11/5/2012,Low Risk,693,702,9,9
11/26/2012,Low Risk,39,135,96,96
11/27/2012,Legal Case,241,478,237,246
11/28/2012,High Risk,140,287,147,145
12/5/2012,Low Risk,474,492,18,18
10/21/2012,High Risk,181,388,207,161
11/16/2012,Low Risk,57,111,54,8
11/20/2012,Low Risk,0,50,50,10
11/17/2012,Low Risk,21,118,97,19
12/10/2012,Low Risk,0,31,31,4
12/9/2012,Low Risk,283,290,7,94
12/7/2012,High Risk,365,417,52,34
11/21/2012,Low Risk,0,103,103,12
11/5/2012,Low Risk,240,471,231,150
10/29/2012,High Risk,151,240,89,86
9/12/2012,Low Risk,125,146,21,21
5/8/2012,Low Risk,736,766,30,30
9/15/2012,Low Risk,660,668,8,8
8/17/2012,Low Risk,153,217,64,64
12/6/2012,Low Risk,354,379,25,25
12/16/2012,Low Risk,278,292,14,41
11/22/2012,Low Risk,43,113,70,9
11/22/2012,High Risk,249,421,172,163
12/1/2012,Low Risk,130,139,9,9
11/28/2012,Low Risk,149,163,14,14
1/2/2013,Low Risk,132,145,13,13
12/17/2012,Low Risk,0,38,38,4
10/7/2012,Low Risk,217,255,38,38
12/24/2012,Low Risk,245,325,80,80
11/25/2012,Low Risk,0,89,89,19
12/13/2012,Low Risk,16,118,102,74
12/20/2012,Low Risk,58,293,235,131
12/17/2012,Low Risk,268,368,100,100
12/20/2012,Low Risk,14,56,42,10
12/30/2012,High Risk,17,117,100,95
11/1/2012,High Risk,147,342,195,188
12/15/2012,Low Risk,163,207,44,15
1/2/2013,High Risk,51,181,130,78
12/5/2012,Low Risk,368,377,9,9
11/26/2012,Low Risk,153,178,25,25
12/27/2012,Low Risk,109,158,49,49
12/31/2012,High Risk,48,156,108,35
6/19/2012,Low Risk,0,252,252,6
12/15/2012,High Risk,47,145,98,121
1/8/2013,High Risk,74,183,109,105
1/8/2013,Low Risk,78,113,35,35
11/6/2012,Low Risk,807,829,22,22
10/31/2012,Low Risk,260,294,34,34
11/28/2012,Low Risk,160,176,16,16
11/18/2012,Low Risk,0,103,103,18
11/16/2012,Low Risk,162,256,94,89
9/24/2012,Low Risk,214,240,26,26
9/24/2012,Low Risk,153,170,17,17
10/1/2012,Low Risk,156,170,14,14
12/6/2012,Low Risk,462,470,8,8
11/16/2012,Low Risk,149,209,60,60
7/5/2012,Low Risk,387,595,208,208
1/13/2013,Low Risk,288,355,67,67
10/1/2012,Low Risk,149,162,13,13
12/19/2012,Low Risk,281,337,56,56
10/10/2012,Low Risk,125,160,35,35
10/8/2012,Low Risk,84,150,66,66
9/30/2012,Low Risk,419,436,17,17
1/11/2013,Low Risk,0,26,26,9
1/16/2013,Low Risk,301,336,35,17
1/7/2013,Low Risk,0,30,30,5
1/16/2013,Low Risk,129,141,12,12
12/28/2012,Low Risk,20,200,180,48
11/1/2012,Low Risk,231,293,62,57
12/19/2012,Low Risk,134,155,21,21
12/27/2012,Low Risk,425,441,16,16
1/12/2013,High Risk,353,437,84,81
1/18/2013,High Risk,98,404,306,287
1/4/2013,Low Risk,72,111,39,39
12/2/2012,Low Risk,108,156,48,48
12/3/2012,High Risk,-1,365,366,287
11/1/2012,Low Risk,211,215,4,4
1/23/2013,Low Risk,0,27,27,4
1/14/2013,Low Risk,0,37,37,4
1/28/2013,Low Risk,0,22,22,4
12/17/2012,Low Risk,51,125,74,14
9/15/2012,Low Risk,135,179,44,44
12/24/2012,Low Risk,0,65,65,8
1/23/2013,Low Risk,69,134,65,62
1/10/2013,Low Risk,56,162,106,52
1/2/2013,Low Risk,147,252,105,75
1/9/2013,Low Risk,0,90,90,27
2/2/2013,High Risk,83,214,131,98
12/5/2012,Low Risk,138,153,15,15
12/2/2012,Low Risk,159,232,73,73
12/20/2012,High Risk,104,167,63,58
1/8/2013,High Risk,91,224,133,168
1/16/2013,Low Risk,150,159,9,9
12/20/2012,High Risk,116,356,240,231
1/11/2013,Low Risk,19,138,119,35
1/2/2013,Low Risk,194,229,35,35
1/11/2013,High Risk,-1,221,222,173
1/26/2013,High Risk,374,404,30,56
1/5/2013,High Risk,94,152,58,52
11/12/2012,Low Risk,0,205,205,9
12/28/2012,Low Risk,660,668,8,8
12/27/2012,Low Risk,55,229,174,174
1/29/2013,Low Risk,439,469,30,13
1/31/2013,Low Risk,0,28,28,5
1/13/2013,Low Risk,315,331,16,34
1/22/2013,Low Risk,172,177,5,5
12/21/2012,Low Risk,77,334,257,58
12/12/2012,Low Risk,89,210,121,57
2/19/2013,Low Risk,29,112,83,23
1/15/2013,High Risk,123,219,96,78
12/14/2012,High Risk,0,209,209,195
12/19/2012,Low Risk,300,385,85,80
2/18/2013,Low Risk,250,268,18,17
12/19/2012,High Risk,-1,250,251,356
2/16/2013,Low Risk,0,20,20,7
2/8/2013,High Risk,175,276,101,93
1/28/2013,Low Risk,0,39,39,5
2/21/2013,Low Risk,0,15,15,11
1/30/2013,Low Risk,135,208,73,65
7/25/2012,Low Risk,60,215,155,155
2/12/2013,Low Risk,139,169,30,30
2/18/2013,High Risk,57,149,92,96
2/21/2013,Low Risk,23,27,4,4
2/20/2013,Low Risk,18,23,5,5
11/19/2012,Low Risk,194,206,12,12
11/27/2012,Low Risk,104,108,4,4
2/19/2013,Low Risk,108,112,4,4
3/4/2013,Low Risk,10,14,4,4
6/21/2012,Low Risk,273,285,12,12
1/11/2013,Low Risk,159,208,49,45
10/8/2012,High Risk,214,403,189,85
1/9/2013,Low Risk,13,77,64,4
11/10/2012,Low Risk,80,124,44,44
11/12/2012,Low Risk,188,241,53,53
10/25/2012,Low Risk,131,141,10,10
12/18/2012,Low Risk,307,387,80,97
11/22/2012,Low Risk,103,113,10,10
11/30/2012,Low Risk,452,482,30,30
12/19/2012,Low Risk,98,119,21,21
12/21/2012,Low Risk,586,602,16,16
2/14/2013,Low Risk,467,501,34,34
1/8/2013,High Risk,-26,141,167,152
11/25/2012,Low Risk,123,136,13,13
2/2/2013,Low Risk,0,76,76,11
2/19/2013,Low Risk,346,444,98,151
10/22/2012,Low Risk,35,305,270,117
2/19/2013,Low Risk,185,219,34,34
1/28/2013,Low Risk,119,214,95,95
3/7/2013,High Risk,120,215,95,112
1/23/2013,Low Risk,240,303,63,63
2/25/2013,High Risk,240,296,56,55
2/19/2013,Low Risk,339,373,34,14
2/7/2013,Low Risk,159,200,41,35
8/27/2012,High Risk,352,689,337,562
2/23/2013,Low Risk,0,30,30,4
2/27/2013,Low Risk,219,322,103,103
12/20/2012,Low Risk,147,383,236,188
3/2/2013,High Risk,210,313,103,146
1/22/2013,Low Risk,180,260,80,15
3/3/2013,Low Risk,-4,53,57,57
1/18/2013,High Risk,99,173,74,70
3/5/2013,Low Risk,157,185,28,28
3/10/2013,Low Risk,13,53,40,6
3/4/2013,Low Risk,28,32,4,4
3/16/2013,Low Risk,262,277,15,15
3/1/2013,Low Risk,319,371,52,12
1/15/2013,Low Risk,392,407,15,15
1/4/2013,Low Risk,225,271,46,46
12/14/2012,Low Risk,139,152,13,13
3/2/2013,High Risk,433,401,-32,104
2/9/2013,High Risk,101,397,296,256
2/22/2013,High Risk,71,116,45,38
3/7/2013,Low Risk,3,161,158,158
1/30/2013,Low Risk,280,320,40,40
1/30/2013,Low Risk,-1,140,141,127
3/8/2013,Low Risk,169,234,65,58
2/4/2013,Low Risk,381,448,67,36
12/4/2012,High Risk,182,309,127,124
3/22/2013,High Risk,0,152,152,123
12/16/2012,Low Risk,100,130,30,30
1/22/2013,Low Risk,218,288,70,70
3/9/2013,High Risk,0,233,233,54
3/3/2013,High Risk,122,249,127,123
10/29/2012,Low Risk,194,221,27,27
11/21/2012,Low Risk,244,268,24,24
2/6/2012,Low Risk,427,431,4,4
4/5/2013,Low Risk,199,234,35,35
10/17/2012,Low Risk,166,177,11,11
2/13/2013,Low Risk,233,246,13,13
2/28/2013,Low Risk,246,314,68,6
3/24/2013,Low Risk,100,138,38,38
1/29/2013,Low Risk,338,380,42,42
2/28/2013,Low Risk,267,327,60,20
3/25/2013,Low Risk,61,65,4,4
1/25/2013,Low Risk,114,132,18,18
1/30/2013,Low Risk,139,195,56,56
1/30/2013,Low Risk,96,112,16,16
1/30/2013,Low Risk,87,119,32,32
3/6/2013,Low Risk,66,113,47,47
3/20/2013,High Risk,42,149,107,100
3/14/2013,Low Risk,57,127,70,20
2/3/2013,Low Risk,127,138,11,11
3/21/2013,High Risk,51,195,144,140
3/1/2013,High Risk,173,235,62,57
2/23/2013,Low Risk,246,256,10,10
3/9/2013,Low Risk,71,170,99,99
3/14/2013,High Risk,32,203,171,58
2/15/2013,Low Risk,110,123,13,13
2/14/2013,High Risk,39,274,235,210
2/4/2013,Low Risk,148,156,8,8
1/31/2013,Low Risk,143,153,10,10
10/10/2012,Low Risk,76,154,78,58
8/24/2012,Low Risk,51,293,242,26
12/24/2012,Low Risk,328,333,5,5
2/19/2013,High Risk,107,177,70,69
2/4/2013,Low Risk,209,373,164,138
3/26/2013,Low Risk,0,31,31,5
2/22/2013,Low Risk,76,139,63,12
3/22/2013,High Risk,280,362,82,74
4/6/2013,Low Risk,0,20,20,4
4/15/2013,Low Risk,0,11,11,7
4/11/2013,Low Risk,0,15,15,4
3/30/2013,Low Risk,15,59,44,5
3/23/2013,Low Risk,127,291,164,158
3/24/2013,High Risk,10,279,269,126
4/4/2013,High Risk,-5,665,670,47
3/27/2013,Low Risk,116,191,75,75
4/9/2013,High Risk,206,259,53,68
4/16/2013,Low Risk,75,92,17,85
4/13/2013,Low Risk,180,214,34,33
4/15/2013,Low Risk,105,150,45,45
4/5/2013,High Risk,-819,-80,739,175
2/23/2013,Low Risk,0,72,72,5
3/28/2013,Low Risk,21,54,33,33
3/30/2013,Low Risk,101,223,122,122
2/21/2013,Low Risk,-194,-8,186,186
3/2/2013,Low Risk,279,346,67,67
1/6/2013,Low Risk,136,264,128,128
4/5/2013,High Risk,189,398,209,97
3/19/2013,High Risk,182,342,160,152
3/1/2013,Low Risk,248,311,63,27
3/5/2013,Low Risk,250,272,22,22
4/11/2013,Low Risk,47,69,22,4
4/5/2013,High Risk,67,217,150,138
2/18/2013,Legal Case,216,645,429,91
2/25/2013,Low Risk,127,144,17,17
2/25/2013,Low Risk,221,255,34,34
3/2/2013,Low Risk,86,109,23,23
3/7/2013,High Risk,677,748,71,180
3/11/2013,High Risk,50,429,379,201
3/18/2013,High Risk,77,443,366,354
3/25/2013,Low Risk,230,247,17,17
4/9/2013,Low Risk,112,128,16,16
4/12/2013,High Risk,100,292,192,99
4/12/2013,High Risk,225,192,-33,72
4/5/2013,Low Risk,88,174,86,86
4/18/2013,Low Risk,0,28,28,5
4/16/2013,Low Risk,0,28,28,7
1/26/2013,Low Risk,132,151,19,19
4/14/2013,Low Risk,114,150,36,15
3/15/2013,Low Risk,216,280,64,64
1/7/2013,Low Risk,139,261,122,107
2/25/2013,High Risk,527,541,14,197
3/27/2013,Low Risk,108,301,193,193
3/6/2013,Low Risk,167,203,36,36
3/10/2013,Low Risk,228,241,13,13
3/19/2013,Low Risk,198,254,56,10
2/22/2013,Low Risk,62,77,15,15
1/14/2013,Low Risk,250,263,13,13
1/25/2013,Low Risk,294,305,11,11
4/3/2013,Low Risk,114,128,14,14
3/13/2013,Legal Case,-127,399,526,330
4/18/2013,Low Risk,0,36,36,7
1/26/2013,Low Risk,42,151,109,22
3/11/2013,Low Risk,311,344,33,33
4/15/2013,Low Risk,28,113,85,8
4/16/2013,Legal Case,-1,329,330,224
4/5/2013,Low Risk,169,216,47,47
4/13/2013,High Risk,49,209,160,138
10/25/2012,Low Risk,769,774,5,5
3/11/2013,Low Risk,99,120,21,21
3/19/2013,High Risk,145,357,212,282
4/13/2013,Low Risk,34,150,116,6
4/25/2013,Low Risk,196,300,104,22
5/1/2013,High Risk,130,203,73,71
5/7/2013,Low Risk,178,196,18,18
3/7/2013,Low Risk,139,147,8,8
4/28/2013,High Risk,143,183,40,38
4/5/2013,Low Risk,13,284,271,271
5/10/2013,Low Risk,200,242,42,42
5/8/2013,Low Risk,359,371,12,12
3/23/2013,Low Risk,125,132,7,7
5/8/2013,Low Risk,105,170,65,65
3/31/2013,Low Risk,50,211,161,161
4/16/2013,Low Risk,214,252,38,38
5/6/2013,Low Risk,410,438,28,16
4/19/2013,Low Risk,429,473,44,44
4/28/2013,Low Risk,0,43,43,7
5/15/2013,Low Risk,86,140,54,54
1/14/2013,High Risk,147,702,555,596
4/24/2013,Low Risk,552,562,10,10
1/7/2013,Low Risk,363,413,50,35
4/10/2013,Low Risk,611,621,10,10
3/14/2013,Low Risk,234,250,16,16
5/17/2013,Low Risk,220,230,10,10
5/22/2013,Low Risk,114,135,21,21
5/15/2013,Low Risk,179,280,101,101
5/29/2013,Legal Case,35,176,141,181
8/17/2011,Low Risk,757,772,15,15
5/24/2012,High Risk,-64,469,533,488
5/22/2013,Low Risk,188,275,87,87
5/7/2013,High Risk,184,230,46,40
6/14/2013,High Risk,112,327,215,211
5/7/2013,Low Risk,56,101,45,25
4/17/2013,Low Risk,114,121,7,7
6/3/2013,Low Risk,158,169,11,11
3/23/2013,Low Risk,134,139,5,5
5/18/2013,Low Risk,356,369,13,13
5/19/2013,Low Risk,84,114,30,30
5/18/2013,High Risk,205,795,590,374
4/17/2013,Low Risk,120,133,13,13
4/30/2013,Low Risk,144,234,90,90
5/20/2013,Low Risk,0,35,35,5
4/16/2013,Low Risk,190,269,79,13
5/27/2013,Low Risk,92,275,183,41
5/16/2013,Low Risk,162,180,18,18
3/18/2013,Low Risk,0,631,631,24
5/1/2013,Low Risk,166,176,10,10
3/18/2013,Low Risk,427,443,16,16
4/10/2013,Low Risk,319,331,12,12
3/21/2013,High Risk,-1,180,181,177
4/7/2013,High Risk,-1,214,215,209
4/11/2013,High Risk,415,399,-16,39
3/22/2013,High Risk,32,179,147,153
5/27/2013,Low Risk,73,340,267,24
6/7/2013,Low Risk,235,287,52,52
6/2/2013,Low Risk,162,177,15,15
5/15/2013,Low Risk,127,155,28,28
6/2/2013,Low Risk,337,347,10,10
5/25/2013,High Risk,121,270,149,144
5/13/2013,Low Risk,177,190,13,13
4/26/2013,Low Risk,63,332,269,171
3/21/2013,Low Risk,289,419,130,11
4/29/2013,Low Risk,121,176,55,50
6/9/2013,Low Risk,111,154,43,43
6/7/2013,Low Risk,131,215,84,84
6/16/2013,Low Risk,332,339,7,7
5/11/2013,Low Risk,331,398,67,7
4/5/2013,Low Risk,-5,201,206,185
4/29/2013,Low Risk,103,182,79,12
3/29/2013,Low Risk,182,194,12,12
6/10/2013,Low Risk,28,121,93,93
6/22/2013,Low Risk,112,171,59,49
6/21/2013,High Risk,140,258,118,118
7/1/2013,Low Risk,86,388,302,271
6/19/2013,High Risk,442,531,89,114
6/28/2013,Low Risk,146,200,54,54
6/24/2013,Low Risk,183,200,17,17
6/21/2013,Low Risk,271,299,28,7
4/23/2013,Low Risk,47,134,87,8
5/30/2013,Low Risk,108,118,10,10
5/16/2013,Low Risk,114,218,104,104
5/26/2013,High Risk,-125,186,311,89
5/3/2013,Low Risk,137,145,8,8
5/31/2013,Low Risk,128,146,18,18
5/14/2013,Low Risk,177,191,14,14
4/18/2013,Low Risk,110,154,44,44
6/18/2013,Low Risk,112,366,254,19
5/2/2013,Low Risk,222,245,23,23
5/30/2013,High Risk,307,606,299,151
5/25/2013,Low Risk,89,111,22,22
6/3/2013,Low Risk,0,119,119,11
5/29/2013,Low Risk,186,196,10,48
6/11/2013,High Risk,324,365,41,62
6/10/2013,Low Risk,229,269,40,40
6/3/2013,Low Risk,105,163,58,5
6/13/2013,Low Risk,105,153,48,11
6/11/2013,Low Risk,0,83,83,4
6/27/2013,Low Risk,20,28,8,8
6/25/2013,Low Risk,187,204,17,17
6/19/2013,High Risk,133,224,91,91
6/6/2013,Low Risk,86,167,81,43
7/3/2013,High Risk,97,226,129,126
6/15/2013,Low Risk,118,124,6,6
6/24/2013,Low Risk,102,150,48,48
5/15/2013,Low Risk,-33,71,104,14
7/10/2013,High Risk,118,182,64,64
6/13/2013,Low Risk,0,74,74,6
6/11/2013,High Risk,239,295,56,44
4/27/2013,Low Risk,23,144,121,44
6/24/2013,High Risk,96,135,39,37
4/17/2013,Low Risk,97,147,50,50
4/27/2013,Low Risk,145,185,40,40
6/13/2013,Low Risk,57,243,186,186
7/7/2013,Low Risk,146,248,102,102
6/2/2013,Low Risk,105,164,59,9
5/14/2013,Low Risk,280,365,85,14
7/1/2013,High Risk,82,267,185,180
5/13/2013,Low Risk,52,165,113,13
6/30/2013,Low Risk,0,61,61,6
4/28/2013,Low Risk,70,183,113,80
6/22/2013,High Risk,-1,235,236,175
6/21/2013,Low Risk,251,327,76,4
6/17/2013,Low Risk,379,388,9,9
6/15/2013,Low Risk,94,107,13,13
6/17/2013,Low Risk,252,332,80,23
6/17/2013,Low Risk,-53,177,230,230
4/15/2013,Low Risk,171,177,6,4
5/2/2013,Low Risk,0,160,160,4
5/29/2013,Low Risk,192,203,11,11
6/13/2013,Low Risk,0,56,56,8
6/19/2013,Low Risk,0,50,50,10
5/16/2013,Low Risk,187,264,77,63
5/28/2013,Low Risk,114,167,53,47
6/11/2013,Low Risk,187,205,18,18
7/28/2013,Low Risk,259,303,44,43
7/11/2013,Low Risk,213,225,12,12
7/15/2013,Low Risk,217,260,43,18
7/2/2013,Low Risk,81,120,39,38
6/26/2013,High Risk,300,378,78,77
6/14/2013,Low Risk,174,188,14,14
7/14/2013,Low Risk,10,110,100,10
7/19/2013,Low Risk,48,88,40,11
7/12/2013,Low Risk,156,208,52,18
6/23/2013,High Risk,17,148,131,113
7/6/2013,Low Risk,314,324,10,10
6/28/2013,Low Risk,109,146,37,37
5/24/2013,Low Risk,44,173,129,14
7/18/2013,High Risk,272,341,69,65
6/30/2013,Low Risk,208,227,19,19
6/17/2013,Low Risk,205,218,13,13
6/18/2013,Low Risk,341,420,79,61
5/9/2013,High Risk,176,217,41,144
6/26/2013,Low Risk,170,237,67,67
7/4/2013,Low Risk,398,475,77,15
7/4/2013,Low Risk,44,196,152,30
7/22/2013,Low Risk,0,37,37,4
8/1/2013,Low Risk,117,138,21,21
7/24/2013,Low Risk,0,33,33,6
7/31/2013,Low Risk,0,304,304,6
6/11/2013,High Risk,51,190,139,133
7/20/2013,Low Risk,0,37,37,6
3/17/2013,Low Risk,661,669,8,8
7/30/2013,Low Risk,179,227,48,48
7/23/2013,Low Risk,122,133,11,11
8/1/2013,Low Risk,140,167,27,27
7/13/2013,Low Risk,0,44,44,5
7/14/2013,Low Risk,450,470,20,20
7/2/2013,Low Risk,490,692,202,202
7/8/2013,Low Risk,186,226,40,40
7/12/2013,Low Risk,189,209,20,20
6/28/2013,Low Risk,180,201,21,21
8/17/2013,Low Risk,198,251,53,9
4/24/2013,High Risk,115,405,290,262
4/16/2013,High Risk,75,205,130,106
4/19/2013,High Risk,53,335,282,234
7/27/2013,Low Risk,293,389,96,96
7/21/2013,Low Risk,709,787,78,88
7/24/2013,Low Risk,101,139,38,38
7/9/2013,Low Risk,130,141,11,11
8/6/2013,Low Risk,141,162,21,21
6/8/2013,Low Risk,53,152,99,99
8/9/2013,Low Risk,138,146,8,8
7/9/2013,High Risk,205,248,43,41
5/31/2013,High Risk,163,250,87,80
6/28/2013,Low Risk,513,579,66,65
7/12/2013,Low Risk,72,196,124,22
8/11/2013,High Risk,168,275,107,104
7/6/2013,High Risk,157,256,99,102
7/21/2013,Low Risk,89,114,25,25
8/6/2013,High Risk,48,133,85,82
8/12/2013,Low Risk,127,178,51,36
6/25/2013,High Risk,120,219,99,94
8/15/2013,High Risk,123,250,127,124
7/31/2013,Low Risk,0,36,36,6
8/1/2013,Low Risk,0,35,35,5
7/25/2013,High Risk,137,455,318,219
8/13/2013,Low Risk,135,162,27,27
7/3/2013,High Risk,546,1272,726,683
7/30/2013,Low Risk,121,135,14,14
7/16/2013,High Risk,173,331,158,130
7/7/2013,Low Risk,84,162,78,12
7/15/2013,Low Risk,39,141,102,11
6/26/2013,Low Risk,28,111,83,16
7/30/2013,High Risk,57,435,378,155
8/19/2013,Low Risk,157,170,13,13
8/2/2013,Low Risk,132,166,34,34
8/17/2013,Low Risk,259,283,24,24
8/20/2013,Low Risk,200,252,52,52
8/7/2013,Low Risk,158,168,10,10
7/26/2013,Low Risk,185,195,10,10
8/1/2013,Low Risk,218,222,4,4
8/5/2013,Low Risk,327,372,45,10
8/2/2013,High Risk,113,350,237,145
8/9/2013,Low Risk,140,159,19,19
8/7/2013,Low Risk,0,43,43,4
8/20/2013,Low Risk,161,211,50,48
5/27/2013,Low Risk,135,302,167,167
8/21/2013,Low Risk,259,484,225,9
6/24/2013,Low Risk,211,248,37,37
8/18/2013,Low Risk,102,122,20,20
8/14/2013,Low Risk,97,155,58,10
8/8/2013,Low Risk,161,175,14,14
8/15/2013,Low Risk,213,224,11,11
8/13/2013,High Risk,-1,185,186,169
8/26/2013,Low Risk,207,245,38,38
8/30/2013,Low Risk,265,278,13,13
8/29/2013,Low Risk,198,217,19,8
8/22/2013,High Risk,0,126,126,101
8/25/2013,Low Risk,106,114,8,8
8/28/2013,Low Risk,122,132,10,10
8/5/2013,Low Risk,170,185,15,15
7/19/2013,Low Risk,109,116,7,7
8/11/2013,Low Risk,98,172,74,10
8/1/2013,Low Risk,127,211,84,16
9/2/2013,High Risk,76,261,185,156
7/16/2013,Low Risk,254,306,52,52
8/31/2013,High Risk,537,605,68,23
8/8/2013,Low Risk,453,515,62,37
9/4/2013,High Risk,74,238,164,151
8/27/2013,Low Risk,429,441,12,12
9/4/2013,Low Risk,106,120,14,14
9/10/2013,Low Risk,341,360,19,19
7/1/2013,Low Risk,93,205,112,7
8/26/2013,Low Risk,142,186,44,21
8/28/2013,High Risk,76,155,79,362
9/6/2013,Low Risk,462,495,33,4
9/6/2013,Low Risk,142,175,33,5
8/23/2013,Low Risk,0,34,34,27
8/5/2013,Low Risk,95,102,7,7
7/7/2013,Low Risk,141,183,42,42
7/28/2013,High Risk,35,142,107,110
7/11/2013,Low Risk,130,495,365,365
8/16/2013,Low Risk,528,543,15,15
6/29/2013,Low Risk,122,136,14,14
8/22/2013,High Risk,406,442,36,89
9/6/2013,High Risk,283,362,79,105
8/20/2013,Low Risk,-10,23,33,33
9/6/2013,High Risk,105,223,118,112
9/4/2013,High Risk,215,294,79,143
8/26/2013,Low Risk,269,346,77,77
8/31/2013,Low Risk,440,621,181,181
12/2/2012,Low Risk,202,288,86,86
8/12/2013,Low Risk,525,625,100,100
9/12/2013,Low Risk,171,182,11,11
8/15/2013,Low Risk,145,153,8,8
8/30/2013,Low Risk,121,131,10,10
9/13/2013,Low Risk,417,501,84,81
8/29/2013,High Risk,45,175,130,112
8/30/2013,High Risk,20,189,169,160
9/22/2013,Low Risk,491,508,17,17
9/7/2013,Low Risk,153,166,13,13
9/19/2013,Low Risk,159,167,8,8
9/7/2013,High Risk,118,178,60,38
8/22/2013,High Risk,165,285,120,117
8/5/2013,Low Risk,167,218,51,51
9/16/2013,Low Risk,76,123,47,47
9/18/2013,Low Risk,193,223,30,30
9/26/2013,Low Risk,107,133,26,38
9/5/2013,Low Risk,150,210,60,9
9/16/2013,High Risk,59,134,75,72
5/24/2013,Low Risk,132,153,21,21
5/20/2013,High Risk,364,541,177,525
6/3/2013,High Risk,72,336,264,188
8/15/2013,Low Risk,78,166,88,88
4/22/2011,Low Risk,861,893,32,32
9/17/2013,High Risk,274,456,182,173
9/4/2013,Low Risk,166,260,94,94
6/5/2013,Low Risk,137,161,24,24
9/17/2013,High Risk,179,239,60,51
5/29/2013,Low Risk,169,183,14,14
5/31/2013,Low Risk,182,195,13,13
9/19/2013,Low Risk,135,202,67,25
6/19/2013,High Risk,-9,212,221,201
9/18/2013,High Risk,91,196,105,101
9/16/2013,High Risk,72,226,154,145
12/19/2012,Low Risk,287,302,15,15
1/7/2013,Low Risk,137,284,147,147
8/13/2013,Low Risk,174,232,58,58
9/14/2013,Low Risk,51,111,60,5
10/12/2013,High Risk,457,643,186,344
9/3/2013,Low Risk,160,191,31,31
8/22/2013,High Risk,366,441,75,295
10/5/2013,High Risk,112,249,137,122
9/24/2013,Low Risk,142,156,14,14
9/26/2013,Low Risk,99,110,11,11
10/7/2013,Low Risk,-276,-230,46,46
10/4/2013,Low Risk,125,133,8,8
7/12/2013,Low Risk,165,194,29,29
8/5/2013,Low Risk,147,218,71,185
9/4/2013,Low Risk,139,197,58,55
10/11/2013,Low Risk,129,174,45,40
10/4/2013,Low Risk,179,221,42,42
10/16/2013,Low Risk,0,69,69,68
10/11/2013,Low Risk,164,244,80,80
9/17/2013,Low Risk,177,183,6,6
9/25/2013,High Risk,42,665,623,162
9/15/2013,Low Risk,71,191,120,22
12/4/2012,Low Risk,253,315,62,62
9/13/2013,High Risk,74,243,169,155
10/17/2013,Low Risk,98,132,34,34
10/13/2013,High Risk,-4,4,8,241
10/11/2013,Legal Case,188,272,84,192
10/17/2013,Low Risk,49,56,7,7
10/6/2013,Low Risk,135,185,50,5
9/17/2013,Low Risk,152,211,59,11
9/1/2013,Low Risk,159,213,54,39
10/10/2013,Low Risk,304,312,8,8
10/11/2013,Low Risk,189,194,5,5
10/11/2013,Low Risk,103,133,30,30
9/14/2013,High Risk,105,174,69,66
9/11/2013,Low Risk,-7,41,48,48
8/2/2013,Low Risk,39,81,42,42
9/12/2013,High Risk,230,323,93,128
8/25/2013,Low Risk,126,145,19,19
10/4/2013,High Risk,385,1151,766,700
9/10/2013,High Risk,57,149,92,89
9/30/2013,Low Risk,329,429,100,14
9/20/2013,High Risk,-14,33,47,1087
10/18/2013,Low Risk,104,153,49,13
10/18/2013,Low Risk,140,180,40,16
10/14/2013,Low Risk,15,28,13,13
10/12/2013,High Risk,57,363,306,286
10/21/2013,Low Risk,421,438,17,17
10/27/2013,High Risk,74,164,90,77
10/25/2013,Low Risk,174,194,20,11
10/23/2013,Low Risk,159,215,56,56
10/9/2013,Low Risk,214,280,66,32
9/13/2013,Legal Case,85,161,76,21
9/28/2013,Low Risk,120,181,61,12
9/30/2013,Low Risk,236,287,51,65
10/26/2013,Low Risk,135,165,30,23
10/4/2013,Low Risk,157,166,9,9
10/10/2013,High Risk,56,211,155,93
10/2/2013,Low Risk,153,169,16,16
10/21/2013,Low Risk,179,184,5,5
11/7/2013,Low Risk,1717,1743,26,26
10/21/2011,Low Risk,849,875,26,26
11/12/2013,Low Risk,112,135,23,22
10/18/2013,High Risk,-21,229,250,132
9/19/2013,Low Risk,117,138,21,21
10/24/2013,Low Risk,171,209,38,38
11/13/2013,Low Risk,193,266,73,73
10/30/2013,High Risk,120,442,322,197
11/1/2013,High Risk,136,231,95,92
10/25/2013,Low Risk,108,150,42,14
10/30/2013,Low Risk,134,196,62,62
11/5/2013,Low Risk,108,139,31,16
9/24/2013,Low Risk,148,204,56,56
10/12/2013,Low Risk,133,144,11,11
11/22/2013,Low Risk,253,277,24,11
11/21/2013,Low Risk,8,238,230,230
10/29/2013,High Risk,72,365,293,62
11/12/2013,Low Risk,179,192,13,13
11/7/2013,High Risk,504,574,70,538
9/20/2013,High Risk,111,476,365,226
10/4/2013,Low Risk,126,234,108,104
11/16/2013,Low Risk,269,283,14,14
11/12/2013,High Risk,296,440,144,123
11/22/2013,Low Risk,254,269,15,15
10/24/2013,Low Risk,530,546,16,16
10/19/2013,Low Risk,173,206,33,33
11/6/2013,Low Risk,68,90,22,22
10/5/2013,Low Risk,115,122,7,7
11/2/2013,High Risk,289,429,140,129
10/31/2013,Low Risk,0,63,63,4
10/16/2013,High Risk,119,792,673,347
10/24/2013,High Risk,60,166,106,101
10/20/2013,High Risk,121,255,134,129
11/15/2013,Low Risk,54,173,119,16
9/26/2013,Low Risk,176,224,48,46
10/2/2013,Low Risk,177,183,6,6
9/9/2013,Low Risk,129,150,21,21
11/16/2013,Low Risk,353,359,6,6
11/25/2013,Low Risk,175,234,59,59
11/27/2013,High Risk,243,253,10,57
11/24/2013,High Risk,112,233,121,115
11/23/2013,Low Risk,120,131,11,11
11/11/2013,Low Risk,72,114,42,11
12/2/2013,Low Risk,177,220,43,43
10/28/2013,High Risk,104,382,278,290
11/8/2013,High Risk,182,551,369,154
11/1/2013,Low Risk,109,146,37,37
12/5/2013,Low Risk,65,366,301,56
11/25/2013,Low Risk,106,190,84,16
10/7/2013,Low Risk,84,171,87,21
12/3/2013,Low Risk,367,437,70,65
11/10/2013,Low Risk,162,199,37,37
1/2/2014,Low Risk,147,223,76,50
11/8/2013,High Risk,125,223,98,93
12/2/2013,High Risk,142,262,120,88
1/2/2014,High Risk,-158,539,697,436
12/10/2013,Low Risk,8,261,253,253
12/5/2013,Low Risk,205,260,55,55
12/16/2013,Low Risk,106,149,43,21
12/10/2013,Low Risk,36,85,49,8
11/17/2013,Low Risk,166,232,66,63
12/8/2013,Low Risk,0,94,94,6
12/26/2013,High Risk,224,300,76,78
12/6/2013,Low Risk,50,158,108,103
11/25/2013,Low Risk,41,99,58,12
12/13/2013,Low Risk,234,256,22,22
1/3/2014,Low Risk,225,235,10,10
12/24/2013,Low Risk,128,136,8,8
12/14/2013,Low Risk,409,425,16,16
12/2/2013,Low Risk,497,564,67,67
12/25/2013,Low Risk,182,337,155,149
12/21/2013,Low Risk,97,111,14,14
12/21/2013,Low Risk,106,144,38,20
12/17/2013,Low Risk,260,302,42,18
1/12/2014,High Risk,83,340,257,222
12/2/2013,High Risk,56,157,101,202
1/15/2014,High Risk,82,182,100,90
12/26/2013,Low Risk,113,174,61,6
1/11/2014,High Risk,59,257,198,118
1/6/2014,Low Risk,245,255,10,55
1/5/2014,Low Risk,365,415,50,8
1/2/2014,High Risk,69,166,97,93
12/24/2013,Low Risk,569,599,30,30
12/30/2013,Low Risk,128,163,35,32
11/16/2013,Low Risk,329,480,151,151
11/27/2013,High Risk,-1,463,464,320
12/31/2013,Low Risk,13,112,99,94
1/17/2014,Low Risk,101,153,52,26
1/15/2014,Low Risk,62,163,101,72
1/3/2014,Low Risk,187,196,9,9
1/4/2014,Low Risk,259,264,5,5
1/21/2014,Legal Case,194,693,499,50
1/7/2014,Low Risk,248,265,17,17
1/24/2014,Low Risk,128,138,10,10
1/27/2014,High Risk,59,186,127,143
12/27/2013,Low Risk,438,445,7,7
1/21/2014,Low Risk,345,365,20,20
11/12/2013,Low Risk,335,364,29,29
12/8/2013,Low Risk,0,74,74,7
2/2/2014,Low Risk,0,19,19,9
1/14/2014,Low Risk,144,185,41,32
1/20/2014,High Risk,110,303,193,186
12/30/2013,Low Risk,71,472,401,25
1/28/2014,Low Risk,322,330,8,8
1/28/2014,Low Risk,29,42,13,13
12/25/2013,High Risk,555,693,138,173
1/26/2014,Low Risk,81,171,90,90
1/15/2014,Low Risk,151,205,54,9
2/12/2014,Low Risk,0,19,19,8
2/17/2014,Low Risk,0,23,23,5
2/8/2014,Low Risk,115,125,10,10
2/4/2014,Low Risk,148,162,14,14
2/10/2014,Low Risk,0,155,155,16
2/10/2014,Low Risk,152,162,10,10
2/5/2014,Low Risk,153,162,9,9
12/24/2013,Low Risk,220,245,25,25
2/3/2014,High Risk,391,448,57,57
2/6/2014,Low Risk,141,173,32,15
2/7/2014,Low Risk,236,271,35,43
2/11/2014,Low Risk,322,330,8,8
2/14/2014,Low Risk,124,166,42,42
2/19/2014,Low Risk,101,245,144,144
1/20/2014,High Risk,199,317,118,86
2/13/2014,Low Risk,120,134,14,14
1/23/2014,Low Risk,252,266,14,14
2/11/2014,Low Risk,106,120,14,14
1/27/2014,Low Risk,258,310,52,10
2/20/2014,Low Risk,274,455,181,12
1/6/2014,Low Risk,-2,64,66,18
2/9/2014,Low Risk,161,508,347,347
11/11/2013,High Risk,146,323,177,35
1/18/2014,Low Risk,52,241,189,144
2/20/2014,Low Risk,103,132,29,29
2/14/2014,Low Risk,139,147,8,8
2/13/2014,Low Risk,103,117,14,14
3/7/2014,High Risk,-130,525,655,533
2/19/2014,High Risk,251,411,160,138
3/6/2014,Low Risk,275,405,130,23
2/18/2014,Low Risk,125,143,18,18
2/28/2014,High Risk,202,433,231,226
2/28/2014,Low Risk,190,213,23,23
2/15/2014,Low Risk,266,396,130,130
2/21/2014,Low Risk,0,38,38,5
1/9/2014,Low Risk,138,228,90,47
2/27/2014,Low Risk,3,32,29,4
1/16/2014,Low Risk,275,302,27,27
1/5/2014,High Risk,96,473,377,348
1/30/2014,Low Risk,101,126,25,25
3/1/2014,Low Risk,106,124,18,18
1/9/2014,Low Risk,155,168,13,13
3/1/2014,High Risk,-1,193,194,38
1/11/2014,High Risk,-33,327,360,299
2/25/2014,Low Risk,143,153,10,10
3/4/2014,Low Risk,96,108,12,12
2/21/2014,High Risk,175,236,61,57
2/8/2014,Low Risk,243,340,97,14
2/26/2014,Low Risk,271,294,23,36
3/8/2014,Low Risk,152,170,18,18
3/2/2014,Low Risk,128,255,127,127
2/4/2014,Low Risk,268,274,6,6
2/28/2014,Low Risk,127,201,74,74
3/12/2014,Low Risk,184,211,27,47
3/13/2014,High Risk,-150,306,456,399
3/13/2014,Low Risk,122,132,10,10
3/13/2014,Low Risk,220,232,12,12
5/9/2013,Low Risk,523,536,13,13
1/25/2014,Low Risk,127,194,67,9
2/28/2014,Low Risk,259,269,10,10
3/12/2014,Low Risk,0,36,36,6
1/28/2014,Low Risk,0,115,115,5
3/23/2014,High Risk,-377,-39,338,281
3/12/2014,Low Risk,28,62,34,13
3/31/2014,Low Risk,121,219,98,98
3/18/2014,High Risk,-27,140,167,139
3/14/2014,High Risk,72,243,171,66
2/20/2014,Low Risk,125,181,56,58
1/3/2014,Low Risk,77,133,56,56
1/5/2014,Low Risk,0,93,93,10
3/19/2014,Low Risk,24,58,34,9
3/10/2014,Low Risk,86,368,282,28
3/29/2014,Low Risk,129,200,71,71
2/20/2014,Low Risk,0,181,181,17
3/19/2014,Low Risk,62,847,785,25
3/24/2014,High Risk,218,325,107,256
3/14/2014,Low Risk,118,181,63,65
2/13/2014,Low Risk,0,123,123,7
1/7/2014,Low Risk,223,231,8,8
2/7/2014,Low Risk,56,130,74,73
2/9/2014,Low Risk,7,51,44,44
3/9/2014,High Risk,83,205,122,36
3/21/2014,High Risk,272,383,111,103
3/5/2014,Low Risk,60,116,56,18
2/13/2014,Low Risk,172,181,9,9
3/29/2014,Low Risk,229,291,62,62
3/14/2014,Low Risk,7,161,154,37
4/10/2014,Low Risk,97,189,92,61
4/8/2014,High Risk,522,436,-86,283
3/24/2014,Low Risk,184,252,68,68
4/18/2014,High Risk,-48,242,290,94
4/1/2014,High Risk,3,133,130,31
4/10/2014,Low Risk,310,336,26,26
1/13/2014,Low Risk,66,178,112,60
4/20/2014,High Risk,296,416,120,130
3/26/2014,Low Risk,100,147,47,10
4/22/2014,Low Risk,222,230,8,8
4/27/2014,Low Risk,139,184,45,27
4/14/2014,High Risk,320,366,46,353
4/12/2014,Low Risk,492,500,8,8
3/18/2014,Low Risk,699,722,23,23
4/27/2014,Low Risk,187,229,42,42
5/1/2014,High Risk,93,133,40,34
3/28/2014,Low Risk,40,89,49,6
5/9/2014,Low Risk,115,126,11,14
4/15/2014,Low Risk,221,237,16,16
5/14/2014,Low Risk,212,301,89,13
4/27/2014,High Risk,130,318,188,181
2/28/2014,Low Risk,220,524,304,304
5/9/2014,High Risk,289,334,45,97
5/20/2014,High Risk,142,351,209,183
4/16/2014,High Risk,104,113,9,93
4/28/2014,Low Risk,0,162,162,82
4/12/2014,Low Risk,301,328,27,27
1/16/2014,High Risk,314,768,454,304
5/10/2014,High Risk,88,237,149,132
5/1/2014,Low Risk,20,54,34,11
4/16/2014,Low Risk,243,251,8,8
4/7/2014,Low Risk,127,136,9,9
4/8/2014,Low Risk,54,238,184,76
5/6/2014,Low Risk,174,182,8,8
5/12/2014,Low Risk,148,156,8,8
4/30/2014,Low Risk,307,314,7,7
5/18/2014,High Risk,796,829,33,320
5/18/2014,Low Risk,195,234,39,39
3/30/2014,Low Risk,142,179,37,37
5/30/2014,High Risk,9,132,123,112
5/23/2014,Low Risk,74,96,22,22
5/11/2014,Low Risk,441,471,30,30
5/14/2014,Low Risk,76,99,23,23
4/12/2014,Low Risk,226,306,80,80
5/19/2014,High Risk,-147,309,456,89
4/17/2014,High Risk,105,181,76,46
4/9/2014,Low Risk,-7,48,55,55
4/30/2014,High Risk,73,141,68,66
4/29/2014,Low Risk,89,135,46,46
5/12/2014,High Risk,132,178,46,45
5/15/2014,Low Risk,44,85,41,5
5/14/2014,Low Risk,85,96,11,11
5/15/2014,High Risk,32,232,200,171
5/8/2014,Low Risk,99,148,49,49
3/27/2014,Low Risk,17,62,45,45
12/2/2013,Low Risk,383,462,79,77
4/11/2014,Low Risk,-14,47,61,61
6/1/2014,Low Risk,424,444,20,20
5/20/2014,High Risk,126,380,254,232
5/22/2014,High Risk,84,146,62,60
5/17/2014,Low Risk,149,198,49,49
5/27/2014,Low Risk,0,80,80,16
6/3/2014,Low Risk,0,73,73,16
5/19/2014,Low Risk,119,168,49,47
5/26/2014,Low Risk,127,134,7,7
5/22/2014,High Risk,-112,356,468,121
6/5/2014,High Risk,-20,427,447,415
5/31/2014,Low Risk,83,146,63,63
6/1/2014,Low Risk,118,137,19,19
6/4/2014,Low Risk,56,83,27,27
4/4/2014,Low Risk,0,229,229,10
5/20/2014,Low Risk,0,87,87,29
5/26/2014,Low Risk,132,142,10,10
5/30/2014,Low Risk,484,495,11,11
6/6/2014,Low Risk,191,215,24,24
4/10/2014,Low Risk,148,245,97,30
5/25/2014,Low Risk,-18,16,34,34
5/19/2014,High Risk,-37,254,291,137
5/28/2014,Low Risk,236,271,35,10
5/21/2014,Low Risk,406,450,44,37
3/31/2014,High Risk,57,171,114,104
5/5/2014,Low Risk,-12,36,48,48
5/15/2014,High Risk,119,208,89,80
6/3/2014,Low Risk,-111,385,496,55
6/10/2014,High Risk,137,217,80,79
6/10/2014,Low Risk,132,155,23,18
5/15/2014,Low Risk,211,264,53,31
5/16/2014,Low Risk,171,189,18,18
5/15/2014,Low Risk,81,188,107,107
6/12/2014,Low Risk,23,43,20,19
5/16/2014,Low Risk,183,194,11,11
6/14/2014,Low Risk,337,341,4,4
5/30/2014,Low Risk,25,34,9,9
6/4/2014,Low Risk,37,106,69,69
6/7/2014,High Risk,193,230,37,128
5/23/2014,Low Risk,462,476,14,14
6/11/2014,Low Risk,174,236,62,62
5/29/2014,Low Risk,185,229,44,44
4/16/2014,High Risk,75,238,163,166
6/20/2014,High Risk,88,346,258,167
5/8/2014,Low Risk,99,112,13,13
6/1/2014,Low Risk,157,165,8,8
6/6/2014,Low Risk,116,133,17,60
6/25/2014,Low Risk,225,259,34,24
5/12/2014,Low Risk,109,198,89,88
6/2/2014,Low Risk,106,191,85,29
6/17/2014,Low Risk,113,127,14,14
6/24/2014,Low Risk,430,442,12,12
6/29/2014,Low Risk,91,136,45,44
5/27/2014,Legal Case,21,190,169,102
1/25/2014,Low Risk,201,389,188,25
6/9/2014,Low Risk,107,177,70,20
7/6/2014,Low Risk,403,411,8,8
6/17/2014,Low Risk,163,177,14,14
7/3/2014,Low Risk,0,48,48,30
7/6/2014,Low Risk,63,108,45,9
7/7/2014,Low Risk,0,44,44,18
7/7/2014,Low Risk,0,49,49,10
6/14/2014,Legal Case,261,460,199,552
7/9/2014,Low Risk,643,691,48,13
7/5/2014,High Risk,212,256,44,37
6/24/2014,Low Risk,27,91,64,10
6/29/2014,Low Risk,112,171,59,18
6/28/2014,Low Risk,26,88,62,25
6/30/2014,Low Risk,49,135,86,25
12/9/2013,High Risk,106,430,324,228
7/2/2014,Low Risk,268,295,27,19
6/22/2014,High Risk,-1,276,277,238
5/31/2014,Low Risk,602,809,207,34
7/1/2014,High Risk,181,225,44,39
6/15/2014,Low Risk,69,144,75,29
7/1/2014,High Risk,-1,344,345,335
6/22/2014,Low Risk,173,180,7,7
7/7/2014,Low Risk,0,36,36,28
6/27/2014,High Risk,174,385,211,249
7/8/2014,Low Risk,22,78,56,12
7/5/2014,High Risk,87,355,268,220
6/5/2014,Low Risk,0,89,89,8
7/7/2014,Low Risk,179,198,19,19
6/28/2014,Low Risk,85,151,66,12
6/11/2014,Low Risk,212,280,68,63
7/4/2014,High Risk,-14,180,194,176
7/9/2014,High Risk,100,140,40,40
7/24/2014,High Risk,213,224,11,43
7/16/2014,Low Risk,258,267,9,9
7/5/2014,Low Risk,243,256,13,13
7/1/2014,Low Risk,789,827,38,38
7/18/2014,Low Risk,0,68,68,13
6/27/2014,Legal Case,188,384,196,888
7/10/2014,Low Risk,162,204,42,43
7/5/2014,High Risk,104,215,111,102
6/29/2014,Low Risk,183,270,87,10
7/7/2014,Low Risk,349,380,31,10
7/13/2014,High Risk,122,277,155,151
7/8/2014,Low Risk,59,70,11,11
7/12/2014,High Risk,85,249,164,161
7/27/2014,Low Risk,364,409,45,129
12/6/2013,Low Risk,188,246,58,58
7/27/2014,Low Risk,0,59,59,9
7/9/2014,Low Risk,186,204,18,18
7/31/2014,Low Risk,39,46,7,111
7/24/2014,High Risk,85,187,102,100
6/23/2014,Low Risk,80,144,64,34
6/20/2014,Low Risk,231,249,18,18
7/10/2014,Low Risk,178,203,25,25
6/29/2014,Low Risk,-41,36,77,77
6/26/2014,High Risk,161,293,132,128
7/17/2014,High Risk,87,130,43,35
6/13/2014,High Risk,-388,272,660,615
5/9/2014,Low Risk,160,166,6,6
5/19/2014,Low Risk,0,99,99,6
6/3/2014,Low Risk,146,156,10,10
7/28/2014,Low Risk,0,59,59,10
6/29/2014,Low Risk,78,135,57,50
8/5/2014,High Risk,107,197,90,86
7/29/2014,Low Risk,104,162,58,22
7/31/2014,Low Risk,0,57,57,18
8/9/2014,High Risk,-290,336,626,542
8/15/2014,High Risk,64,158,94,93
8/7/2014,Low Risk,0,50,50,9
8/5/2014,Low Risk,141,154,13,13
6/25/2014,Low Risk,285,329,44,43
7/17/2014,Low Risk,372,474,102,77
8/4/2014,Low Risk,262,364,102,86
7/21/2014,High Risk,121,662,541,523
7/22/2014,High Risk,209,315,106,80
8/13/2014,Low Risk,161,169,8,8
8/6/2014,Low Risk,338,350,12,12
8/13/2014,Low Risk,70,238,168,47
8/5/2014,Low Risk,122,141,19,19
8/14/2014,Low Risk,154,168,14,14
8/5/2014,Low Risk,0,55,55,17
7/23/2014,Low Risk,0,65,65,20
7/26/2014,Low Risk,133,214,81,81
8/5/2014,Low Risk,113,162,49,10
8/12/2014,High Risk,106,232,126,123
8/12/2014,High Risk,73,220,147,148
8/25/2014,Low Risk,349,366,17,266
7/7/2014,High Risk,-14,702,716,344
8/4/2014,Low Risk,0,84,84,8
8/9/2014,Low Risk,269,277,8,8
8/27/2014,High Risk,147,205,58,38
8/7/2014,Low Risk,232,301,69,30
7/12/2014,Low Risk,98,111,13,13
8/29/2014,High Risk,62,684,622,150
8/22/2014,Low Risk,0,66,66,10
8/28/2014,High Risk,-14,280,294,51
7/17/2014,High Risk,279,371,92,71
9/13/2014,Low Risk,121,131,10,10
8/13/2014,High Risk,-24,268,292,255
9/2/2014,Low Risk,62,70,8,8
9/14/2013,Low Risk,305,355,50,50
8/1/2014,High Risk,49,167,118,90
8/13/2014,Low Risk,199,218,19,19
9/15/2014,Legal Case,104,637,533,74
4/28/2014,Low Risk,192,205,13,13
8/28/2014,High Risk,91,209,118,115
8/22/2014,Low Risk,35,84,49,10
9/10/2014,Low Risk,141,149,8,8
9/12/2014,Low Risk,189,264,75,59
9/4/2014,Low Risk,127,188,61,61
8/23/2014,Low Risk,162,200,38,30
8/29/2014,Low Risk,107,137,30,30
7/23/2014,High Risk,107,196,89,64
8/28/2014,High Risk,157,253,96,40
9/5/2014,Low Risk,37,91,54,36
9/5/2014,Low Risk,0,77,77,9
9/23/2014,Low Risk,98,129,31,31
9/17/2014,Low Risk,148,160,12,12
9/29/2014,High Risk,108,136,28,384
9/17/2014,Low Risk,152,163,11,11
8/31/2014,Low Risk,0,78,78,15
9/17/2014,High Risk,106,518,412,283
9/22/2014,Low Risk,380,406,26,26
10/2/2014,Low Risk,107,132,25,25
10/2/2014,Low Risk,116,134,18,18
9/27/2014,Low Risk,100,131,31,4
9/23/2014,High Risk,205,239,34,123
8/28/2014,Low Risk,196,236,40,40
8/25/2014,Low Risk,134,431,297,28
9/15/2014,High Risk,382,546,164,84
9/16/2014,Low Risk,425,498,73,73
9/12/2014,High Risk,69,137,68,29
10/9/2014,Low Risk,69,131,62,62
8/28/2014,Low Risk,0,84,84,28
9/9/2014,Low Risk,0,196,196,20
8/29/2014,Low Risk,64,224,160,160
9/8/2014,Low Risk,387,415,28,28
9/30/2014,Low Risk,91,126,35,30
10/13/2014,Low Risk,323,331,8,8
10/11/2014,High Risk,-30,438,468,426
10/13/2014,High Risk,-27,599,626,412
9/26/2014,Low Risk,337,370,33,33
10/20/2014,Low Risk,218,395,177,8
10/3/2014,Low Risk,69,124,55,8
10/3/2014,Low Risk,0,89,89,10
10/8/2014,Low Risk,101,142,41,41
10/21/2014,Low Risk,138,175,37,12
10/23/2014,High Risk,-26,202,228,141
10/10/2014,High Risk,139,250,111,108
9/5/2014,Low Risk,388,397,9,9
10/2/2014,Low Risk,16,62,46,11
9/15/2014,Low Risk,163,179,16,16
10/21/2014,Low Risk,143,157,14,14
10/14/2014,Low Risk,87,91,4,4
10/18/2014,Low Risk,63,83,20,20
9/27/2014,Low Risk,178,199,21,21
9/15/2014,Low Risk,64,123,59,13
10/22/2014,Low Risk,21,649,628,628
10/17/2014,Low Risk,128,160,32,32
10/18/2014,Low Risk,0,65,65,23
9/19/2014,Low Risk,0,63,63,8
6/2/2014,High Risk,128,303,175,172
9/15/2014,Low Risk,365,415,50,38
10/20/2014,High Risk,108,151,43,32
9/9/2014,High Risk,71,372,301,288
9/26/2014,Low Risk,108,124,16,16
7/12/2014,Low Risk,90,122,32,32
10/8/2014,Low Risk,104,155,51,27
10/23/2014,Low Risk,89,167,78,76
10/22/2014,Low Risk,97,142,45,45
11/2/2014,High Risk,55,290,235,224
10/17/2014,High Risk,184,375,191,159
10/16/2014,Low Risk,123,138,15,15
10/13/2014,Low Risk,0,50,50,8
10/31/2014,High Risk,269,454,185,21
10/21/2014,Low Risk,177,219,42,42
10/7/2014,Low Risk,36,121,85,13
10/5/2014,Low Risk,117,159,42,40
11/7/2014,Low Risk,107,133,26,26
10/18/2014,Low Risk,175,230,55,55
9/5/2014,Low Risk,328,341,13,13
11/4/2014,High Risk,107,300,193,186
11/11/2014,Low Risk,291,303,12,160
11/11/2014,Low Risk,169,189,20,20
11/10/2014,Low Risk,162,269,107,102
11/22/2014,Low Risk,162,172,10,10
10/29/2014,Low Risk,167,456,289,23
10/23/2014,Low Risk,146,187,41,23
12/3/2014,High Risk,5,196,191,79
11/14/2014,Low Risk,194,243,49,30
10/27/2014,Low Risk,135,163,28,28
11/21/2014,High Risk,95,164,69,46
11/7/2014,Low Risk,277,287,10,10
10/29/2014,Low Risk,182,203,21,21
7/12/2014,High Risk,169,544,375,242
10/27/2014,Low Risk,162,205,43,43
11/3/2014,Low Risk,392,401,9,9
11/12/2014,Low Risk,0,75,75,8
11/7/2014,Low Risk,138,152,14,14
11/17/2014,High Risk,77,323,246,228
11/12/2014,High Risk,-1,287,288,193
11/17/2014,Low Risk,100,151,51,51
12/18/2014,Low Risk,104,182,78,30
11/28/2014,Low Risk,196,250,54,54
11/21/2014,High Risk,210,252,42,150
11/24/2014,Low Risk,0,63,63,17
12/6/2014,Legal Case,154,305,151,139
11/17/2014,High Risk,-1,235,236,199
11/23/2014,Low Risk,111,130,19,19
10/1/2014,Low Risk,128,161,33,33
8/20/2014,Low Risk,88,119,31,31
11/2/2014,Low Risk,0,86,86,23
11/20/2014,Low Risk,364,396,32,32
11/25/2014,High Risk,144,192,48,46
11/20/2014,Low Risk,0,49,49,4
12/9/2014,High Risk,77,197,120,112
12/20/2014,High Risk,-25,138,163,132
12/12/2014,Low Risk,198,250,52,52
11/24/2014,Low Risk,230,276,46,21
12/16/2014,Low Risk,168,211,43,43
11/26/2014,Low Risk,182,237,55,8
12/17/2014,Low Risk,251,259,8,56
12/16/2014,Low Risk,625,645,20,20
12/6/2014,Low Risk,27,158,131,61
12/16/2014,Low Risk,86,143,57,57
12/2/2014,Low Risk,201,252,51,51
12/15/2014,High Risk,19,534,515,302
12/14/2014,Low Risk,826,849,23,23
12/9/2014,Low Risk,170,176,6,6
10/3/2014,Low Risk,74,110,36,36
8/22/2014,High Risk,95,253,158,120
11/24/2014,High Risk,44,95,51,49
12/16/2014,High Risk,559,820,261,228
12/24/2014,Low Risk,71,132,61,24
12/28/2014,Low Risk,129,158,29,29
10/31/2014,High Risk,-122,294,416,290
12/2/2014,Low Risk,151,231,80,80
11/3/2014,Low Risk,242,305,63,63
12/31/2014,Low Risk,98,117,19,19
11/20/2014,Low Risk,54,62,8,8
1/1/2015,Low Risk,7,195,188,188
1/6/2015,Low Risk,447,490,43,43
12/30/2014,Low Risk,462,470,8,8
12/29/2014,High Risk,77,388,311,226
12/31/2014,Low Risk,164,198,34,34
1/5/2015,Low Risk,130,150,20,20
1/14/2015,Low Risk,73,127,54,50
1/5/2015,High Risk,373,611,238,181
1/13/2015,Legal Case,-23,196,219,190
9/4/2014,Low Risk,203,245,42,42
1/3/2015,High Risk,637,817,180,565
12/21/2014,High Risk,87,157,70,65
1/7/2015,High Risk,63,161,98,27
1/11/2015,High Risk,556,558,2,150
12/22/2014,Low Risk,85,137,52,52
1/2/2015,Low Risk,0,53,53,8
1/21/2015,Low Risk,585,603,18,18
1/14/2015,Low Risk,110,140,30,30
1/9/2015,Low Risk,312,567,255,13
1/15/2015,Low Risk,77,146,69,8
1/21/2015,Low Risk,133,141,8,8
1/15/2015,High Risk,123,399,276,124
1/21/2015,Low Risk,400,421,21,21
1/13/2015,Low Risk,163,226,63,62
5/7/2014,Low Risk,279,286,7,7
1/14/2015,Low Risk,409,418,9,9
1/1/2015,High Risk,87,201,114,93
4/10/2014,High Risk,407,897,490,36
1/2/2015,Low Risk,0,81,81,11
12/16/2014,High Risk,71,246,175,140
1/31/2015,Low Risk,82,109,27,30
2/2/2015,Low Risk,55,101,46,46
2/7/2015,High Risk,424,478,54,65
1/21/2015,Low Risk,137,149,12,12
2/4/2015,Low Risk,203,217,14,14
2/2/2015,Low Risk,114,136,22,46
2/8/2015,Low Risk,0,86,86,5
2/5/2015,Low Risk,180,188,8,8
2/2/2015,Low Risk,4,214,210,63
2/12/2015,High Risk,194,264,70,65
2/1/2015,Low Risk,112,131,19,19
1/27/2015,Low Risk,117,134,17,17
1/22/2015,Low Risk,113,258,145,145
2/16/2015,Low Risk,108,161,53,53
2/7/2015,Low Risk,1241,845,-396,292
2/5/2015,Low Risk,104,209,105,99
2/23/2015,High Risk,0,219,219,112
2/18/2015,High Risk,97,146,49,40
11/19/2014,Low Risk,39,159,120,13
2/24/2015,High Risk,97,170,73,70
2/23/2015,Low Risk,43,50,7,7
2/10/2015,Low Risk,83,338,255,14
2/4/2015,Low Risk,216,231,15,15
2/12/2015,Low Risk,159,217,58,58
3/11/2015,High Risk,102,259,157,156
1/29/2015,Low Risk,112,309,197,8
1/23/2015,Low Risk,105,172,67,16
3/1/2015,Low Risk,351,362,11,11
1/18/2015,Low Risk,72,89,17,17
3/13/2015,High Risk,115,256,141,135
3/18/2015,High Risk,218,294,76,68
3/18/2015,Low Risk,190,210,20,20
3/15/2015,High Risk,75,141,66,44
3/18/2015,High Risk,241,323,82,75
2/16/2015,Low Risk,48,129,81,13
3/11/2015,Low Risk,0,77,77,8
2/17/2015,Low Risk,94,147,53,35
3/13/2015,Low Risk,168,202,34,33
3/8/2015,Low Risk,202,257,55,55
3/21/2015,Low Risk,116,132,16,32
2/14/2015,Low Risk,100,170,70,64
3/18/2015,Low Risk,0,34,34,4
3/27/2015,Low Risk,0,25,25,4
3/13/2015,Low Risk,106,153,47,25
3/19/2015,Low Risk,6,139,133,133
3/18/2015,Low Risk,45,72,27,27
2/7/2015,Low Risk,125,180,55,53
12/13/2014,Low Risk,109,359,250,250
3/18/2015,Low Risk,21,188,167,162
4/4/2015,High Risk,36,213,177,142
4/9/2015,Low Risk,137,146,9,9
4/1/2015,Low Risk,134,154,20,20
3/27/2015,Legal Case,91,308,217,136
3/19/2015,High Risk,36,173,137,128
11/13/2014,Low Risk,358,414,56,56
4/6/2015,High Risk,129,231,102,34
4/9/2015,High Risk,155,189,34,61
4/15/2015,High Risk,198,229,31,32
4/16/2015,Low Risk,174,217,43,20
4/8/2015,Low Risk,150,210,60,60
3/3/2015,Low Risk,171,183,12,12
4/1/2015,High Risk,-3,100,103,93
4/5/2015,Low Risk,16,47,31,6
4/8/2015,Low Risk,210,252,42,37
4/6/2015,High Risk,89,115,26,27
4/22/2015,Low Risk,110,155,45,45
4/22/2015,Low Risk,14,41,27,9
4/23/2015,High Risk,112,211,99,86
4/21/2015,Low Risk,284,385,101,101
4/28/2015,High Risk,89,232,143,85
5/12/2015,Low Risk,198,332,134,11
1/22/2015,Low Risk,434,453,19,19
4/27/2015,High Risk,71,130,59,57
5/10/2015,Low Risk,254,298,44,44
4/16/2015,High Risk,223,392,169,178
4/2/2015,High Risk,-19,195,214,86
3/31/2015,High Risk,95,431,336,302
3/12/2015,Low Risk,155,257,102,95
5/18/2015,Low Risk,105,115,10,10
5/10/2015,Low Risk,175,192,17,17
5/4/2015,Low Risk,236,246,10,10
5/30/2015,Low Risk,15,131,116,16
4/16/2015,Low Risk,45,148,103,23
4/28/2015,High Risk,453,491,38,43
5/9/2015,High Risk,129,160,31,29
4/18/2015,High Risk,283,356,73,345
5/12/2015,High Risk,64,91,27,26
5/16/2015,High Risk,104,131,27,26
5/7/2015,High Risk,0,417,417,403
5/24/2015,Low Risk,149,213,64,46
5/15/2015,High Risk,27,151,124,47
5/8/2015,Low Risk,221,313,92,92
6/3/2015,Low Risk,52,100,48,48
4/21/2015,Low Risk,1028,1088,60,48
5/18/2015,Legal Case,160,190,30,94
5/17/2015,Low Risk,34,73,39,8
5/16/2015,High Risk,65,221,156,151
5/23/2015,Low Risk,320,335,15,15
4/4/2015,Low Risk,117,137,20,20
5/11/2015,Low Risk,0,66,66,13
5/13/2015,Low Risk,183,197,14,14
5/20/2015,Low Risk,66,301,235,235
5/30/2015,Low Risk,41,110,69,55
6/2/2015,High Risk,9,279,270,107
5/19/2015,Low Risk,41,55,14,14
5/19/2015,High Risk,324,414,90,509
5/18/2015,High Risk,23,240,217,116
5/7/2015,Low Risk,220,228,8,8
5/21/2015,Low Risk,292,322,30,30
5/16/2015,Low Risk,160,214,54,27
6/1/2015,Low Risk,153,191,38,29
5/24/2015,Legal Case,111,200,89,85
5/8/2015,Low Risk,152,175,23,23
6/6/2015,High Risk,178,367,189,116
4/30/2015,Low Risk,102,183,81,72
5/30/2015,Low Risk,97,157,60,60
5/29/2015,Low Risk,102,150,48,14
6/5/2015,Low Risk,400,439,39,39
6/16/2015,Low Risk,96,218,122,9
5/21/2015,Low Risk,80,124,44,44
5/27/2015,Low Risk,106,113,7,7
6/10/2015,Low Risk,598,639,41,26
6/10/2015,Low Risk,105,173,68,48
6/2/2015,High Risk,-7,162,169,71
6/2/2015,Low Risk,303,311,8,8
6/25/2015,High Risk,-23,194,217,88
6/19/2015,Low Risk,0,209,209,4
6/12/2015,High Risk,93,215,122,116
1/9/2015,Low Risk,251,271,20,20
6/20/2015,Low Risk,157,270,113,113
6/12/2015,Low Risk,380,419,39,51
6/22/2015,Low Risk,27,205,178,21
6/2/2015,High Risk,228,394,166,91
6/21/2015,High Risk,41,157,116,45
6/21/2015,High Risk,111,162,51,49
6/18/2015,Low Risk,0,40,40,19
6/22/2015,High Risk,373,730,357,125
6/16/2015,Low Risk,0,64,64,6
7/2/2015,Low Risk,187,216,29,29
5/26/2015,Low Risk,284,338,54,54
6/28/2015,Low Risk,196,206,10,10
7/3/2015,Low Risk,150,166,16,16
6/15/2015,Low Risk,129,142,13,13
7/9/2015,Low Risk,189,301,112,9
6/5/2015,Low Risk,0,70,70,16
6/29/2015,Low Risk,435,459,24,24
7/9/2015,Low Risk,266,279,13,13
6/23/2015,Low Risk,172,188,16,16
6/26/2015,Low Risk,55,118,63,63
7/6/2015,Low Risk,0,51,51,9
7/3/2015,High Risk,99,179,80,79
6/15/2015,Low Risk,0,92,92,15
7/3/2015,High Risk,90,180,90,87
7/12/2015,High Risk,8,150,142,87
6/26/2015,High Risk,9,357,348,310
7/3/2015,Low Risk,94,132,38,15
6/22/2015,Low Risk,321,406,85,30
6/10/2015,Low Risk,17,92,75,4
7/3/2015,Low Risk,-71,244,315,72
6/5/2015,High Risk,-55,399,454,368
7/13/2015,Low Risk,113,143,30,9
7/23/2015,High Risk,22,99,77,45
7/20/2015,Low Risk,162,170,8,8
7/10/2015,Low Risk,221,318,97,36
7/14/2015,Low Risk,112,148,36,4
4/23/2015,Low Risk,90,189,99,44
7/2/2015,Low Risk,113,132,19,19
7/2/2015,High Risk,396,435,39,39
7/18/2015,High Risk,188,200,12,13
7/13/2015,Low Risk,102,178,76,76
7/28/2015,Low Risk,85,99,14,11
7/3/2015,Legal Case,112,237,125,121
7/29/2015,Low Risk,141,174,33,33
5/19/2015,Low Risk,183,195,12,12
7/7/2015,High Risk,725,892,167,554
6/23/2015,Legal Case,603,730,127,580
7/24/2015,Low Risk,288,362,74,74
7/21/2015,Low Risk,112,126,14,14
7/28/2015,Low Risk,97,118,21,21
7/27/2015,Low Risk,0,43,43,9
8/5/2015,Low Risk,99,111,12,12
8/5/2015,High Risk,96,196,100,42
8/2/2015,High Risk,-33,298,331,168
7/31/2015,Low Risk,88,264,176,176
7/28/2015,Low Risk,0,24,24,10
8/6/2015,Legal Case,447,468,21,488
1/9/2015,Low Risk,440,740,300,16
8/10/2015,Low Risk,319,401,82,82
8/6/2015,Low Risk,1,33,32,7
7/10/2015,Low Risk,138,173,35,35
7/17/2015,High Risk,316,503,187,87
8/5/2015,Low Risk,121,154,33,33
7/20/2015,Low Risk,279,309,30,30
5/9/2015,Low Risk,-107,-72,35,35
7/27/2015,Low Risk,604,737,133,133
7/19/2015,Low Risk,124,143,19,19
8/30/2015,Low Risk,117,128,11,11
8/13/2015,Low Risk,408,469,61,18
7/23/2015,Low Risk,33,47,14,14
7/27/2015,High Risk,128,147,19,19
8/8/2015,Legal Case,318,482,164,403
8/20/2015,High Risk,4,236,232,348
8/24/2015,Low Risk,166,262,96,96
8/27/2015,Low Risk,166,173,7,7
8/30/2015,Low Risk,255,267,12,12
8/21/2015,Low Risk,133,189,56,23
8/14/2015,Low Risk,0,74,74,13
8/29/2015,Low Risk,28,171,143,6
7/28/2015,Low Risk,460,469,9,9
8/26/2015,Low Risk,157,205,48,48
8/13/2015,High Risk,94,582,488,270
7/7/2015,High Risk,72,176,104,101
8/18/2015,Low Risk,0,91,91,18
9/2/2015,Low Risk,113,167,54,23
7/26/2015,Low Risk,89,177,88,8
8/31/2015,Low Risk,34,57,23,7
9/13/2015,Low Risk,141,180,39,35
8/30/2015,Low Risk,382,467,85,85
8/30/2015,Low Risk,237,256,19,19
9/6/2015,Low Risk,208,215,7,7
8/9/2015,Low Risk,38,59,21,21
8/19/2015,Low Risk,415,448,33,32
9/15/2015,Low Risk,13,326,313,313
9/11/2015,High Risk,111,214,103,91
8/23/2015,High Risk,226,297,71,53
9/22/2015,Low Risk,227,303,76,76
9/15/2015,High Risk,116,260,144,138
8/27/2015,Low Risk,0,63,63,8
9/13/2015,High Risk,192,323,131,118
8/15/2015,Low Risk,49,59,10,10
8/14/2015,Low Risk,251,308,57,55
9/26/2015,Low Risk,116,143,27,21
8/11/2015,High Risk,58,274,216,206
8/29/2015,Low Risk,37,47,10,10
6/17/2015,Low Risk,249,453,204,23
9/15/2015,Low Risk,210,253,43,8
9/23/2015,Low Risk,149,166,17,17
9/25/2015,High Risk,18,347,329,32
9/27/2015,Legal Case,9,87,78,25
10/7/2015,Low Risk,63,119,56,56
10/9/2015,Low Risk,284,334,50,50
8/28/2015,High Risk,312,402,90,92
8/1/2015,Low Risk,120,186,66,64
10/6/2015,Legal Case,59,255,196,188
10/4/2015,High Risk,-47,157,204,157
3/17/2015,Low Risk,489,518,29,29
10/3/2015,Low Risk,0,41,41,6
10/16/2015,Low Risk,-649,489,1138,25
10/6/2015,Low Risk,472,503,31,16
8/31/2015,High Risk,83,262,179,109
10/10/2015,Low Risk,121,158,37,37
4/24/2015,Low Risk,188,220,32,32
10/6/2015,Low Risk,0,49,49,14
10/12/2015,Low Risk,89,127,38,10
9/24/2015,Low Risk,-21,48,69,23
10/16/2015,Low Risk,118,123,5,5
10/4/2015,Low Risk,79,99,20,20
10/22/2015,Low Risk,142,195,53,53
10/17/2015,Low Risk,89,122,33,6
10/13/2015,High Risk,357,419,62,52
10/16/2015,Low Risk,193,213,20,10
10/29/2015,Low Risk,91,390,299,282
10/25/2015,Low Risk,152,170,18,15
10/26/2015,Low Risk,76,113,37,11
10/6/2015,Low Risk,203,240,37,37
10/29/2015,Low Risk,88,110,22,8
11/4/2015,Low Risk,0,16,16,9
9/29/2015,Low Risk,148,169,21,21
11/4/2015,Low Risk,272,285,13,13
11/2/2015,High Risk,0,151,151,101
10/21/2015,Low Risk,131,142,11,11
10/29/2015,High Risk,329,467,138,47
11/9/2015,Low Risk,115,182,67,67
10/22/2015,Low Risk,39,113,74,12
11/7/2015,High Risk,148,292,144,141
11/7/2015,Low Risk,-85,23,108,19
5/17/2015,Low Risk,182,193,11,11
10/27/2015,Low Risk,-84,35,119,10
10/13/2015,Low Risk,37,162,125,18
9/30/2015,Legal Case,121,490,369,274
11/16/2015,Low Risk,81,92,11,11
11/18/2015,High Risk,223,341,118,122
11/22/2015,Low Risk,61,86,25,17
11/16/2015,Low Risk,351,374,23,18
9/10/2015,Low Risk,174,209,35,35
11/21/2015,High Risk,36,200,164,114
11/20/2015,High Risk,182,255,73,71
11/13/2015,High Risk,-210,189,399,30
11/25/2015,Low Risk,101,251,150,150
11/18/2015,Low Risk,115,126,11,11
11/13/2015,Low Risk,202,237,35,32
10/4/2015,Low Risk,78,141,63,63
12/8/2015,Low Risk,42,289,247,53
12/4/2015,High Risk,650,775,125,36
11/24/2015,High Risk,0,99,99,104
12/7/2015,Low Risk,295,374,79,79
11/8/2015,Low Risk,223,276,53,51
11/28/2015,Low Risk,249,262,13,13
11/13/2015,Low Risk,0,147,147,12
12/7/2015,Low Risk,276,280,4,4
12/4/2015,Low Risk,125,158,33,6
12/8/2015,Legal Case,150,471,321,186
12/15/2015,High Risk,0,135,135,90
12/12/2015,High Risk,131,340,209,190
10/20/2015,Low Risk,57,70,13,13
10/29/2015,High Risk,-47,252,299,91
12/18/2015,High Risk,71,215,144,126
12/16/2015,Low Risk,0,152,152,10
10/19/2015,High Risk,65,408,343,402
10/25/2015,Low Risk,369,386,17,17
10/26/2015,Low Risk,53,72,19,19
12/9/2015,Low Risk,51,65,14,14
12/11/2015,Low Risk,7,24,17,17
12/19/2015,Low Risk,116,171,55,51
12/16/2015,Low Risk,497,560,63,8
8/31/2015,High Risk,541,567,26,67
10/23/2015,Low Risk,167,388,221,11
12/31/2015,High Risk,7,138,131,31
12/19/2015,Low Risk,24,32,8,8
12/12/2015,Low Risk,0,37,37,15
12/26/2015,Low Risk,135,159,24,10
12/30/2015,High Risk,8,107,99,157
1/3/2016,Low Risk,136,165,29,29
12/6/2015,Low Risk,0,165,165,30
1/5/2016,High Risk,20,454,434,186
12/11/2015,Low Risk,422,433,11,11
1/4/2016,High Risk,85,143,58,54
1/15/2016,Low Risk,59,109,50,47
1/8/2016,High Risk,276,707,431,417
1/7/2016,High Risk,340,418,78,259
12/9/2015,Low Risk,88,124,36,36
1/5/2016,High Risk,217,379,162,127
1/6/2016,High Risk,157,425,268,260
1/17/2016,Low Risk,0,46,46,9
11/19/2015,Low Risk,98,140,42,42
1/9/2016,Low Risk,102,118,16,16
1/9/2016,Low Risk,93,171,78,78
12/31/2015,Low Risk,107,147,40,40
12/11/2015,Low Risk,53,62,9,9
1/19/2016,Low Risk,206,296,90,17
1/14/2016,High Risk,92,251,159,32
1/13/2016,Low Risk,122,133,11,11
1/14/2016,Low Risk,29,69,40,9
1/6/2016,Low Risk,0,78,78,20
1/18/2016,Low Risk,46,85,39,39
1/10/2016,Low Risk,216,222,6,6
1/21/2016,High Risk,132,243,111,70
1/16/2016,Low Risk,68,180,112,112
1/25/2016,Low Risk,11,23,12,12
1/27/2016,Low Risk,173,201,28,28
1/16/2016,High Risk,73,194,121,116
1/14/2016,Low Risk,91,167,76,76
1/16/2016,Low Risk,120,130,10,10
12/23/2015,Low Risk,47,55,8,8
1/21/2016,Low Risk,43,106,63,9
1/21/2016,Low Risk,51,111,60,60
1/19/2016,High Risk,71,135,64,64
1/18/2016,Low Risk,250,280,30,37
12/1/2015,Low Risk,105,260,155,72
12/24/2015,Low Risk,569,636,67,67
1/22/2016,High Risk,-1,104,105,97
1/25/2016,High Risk,167,282,115,98
2/3/2016,Low Risk,28,154,126,95
2/3/2016,Low Risk,56,153,97,97
1/11/2016,High Risk,92,162,70,75
2/15/2016,High Risk,0,416,416,349
2/23/2016,Low Risk,292,518,226,208
12/16/2015,Low Risk,90,127,37,46
2/12/2016,Low Risk,118,143,25,25
2/20/2016,Low Risk,0,30,30,28
1/14/2016,Low Risk,37,48,11,11
2/11/2016,Low Risk,100,112,12,12
2/17/2016,High Risk,20,97,77,83
1/9/2016,Low Risk,0,107,107,10
1/28/2016,Low Risk,37,42,5,5
1/25/2016,Low Risk,0,91,91,8
2/25/2016,Low Risk,0,35,35,4
2/11/2016,Low Risk,125,137,12,12
2/29/2016,Low Risk,45,66,21,21
2/2/2016,Low Risk,115,170,55,55
2/26/2016,High Risk,70,105,35,35
2/24/2016,Low Risk,202,264,62,30
2/23/2016,High Risk,306,468,162,143
3/3/2016,High Risk,99,208,109,113
2/25/2016,Low Risk,432,440,8,8
3/4/2016,Low Risk,185,244,59,59
3/4/2016,Low Risk,242,256,14,14
2/28/2016,High Risk,154,418,264,244
3/9/2016,Low Risk,258,287,29,31
3/7/2016,High Risk,189,392,203,160
3/15/2016,Low Risk,113,176,63,63
2/27/2016,Low Risk,0,33,33,4
2/10/2016,High Risk,51,441,390,357
3/7/2016,High Risk,135,221,86,72
3/3/2016,Low Risk,42,54,12,12
3/15/2016,High Risk,155,359,204,209
3/12/2016,High Risk,145,185,40,46
3/15/2016,Low Risk,0,29,29,4
2/26/2016,Low Risk,0,122,122,18
8/19/2015,Low Risk,181,212,31,31
3/20/2016,High Risk,49,198,149,130
3/19/2016,High Risk,1,151,150,147
2/22/2016,Low Risk,115,178,63,63
2/17/2016,Low Risk,128,217,89,12
3/29/2016,Low Risk,0,29,29,9
3/31/2016,Low Risk,92,183,91,51
3/19/2016,High Risk,75,137,62,75
3/16/2016,High Risk,290,666,376,303
3/30/2016,Low Risk,56,84,28,25
3/17/2016,High Risk,400,447,47,378
3/6/2016,Low Risk,0,52,52,8
4/4/2016,Low Risk,0,16,16,8
3/19/2016,Low Risk,201,249,48,48
3/26/2016,Low Risk,64,97,33,33
4/1/2016,Low Risk,0,76,76,6
3/5/2016,Low Risk,31,47,16,16
4/3/2016,Low Risk,0,37,37,19
3/30/2016,Low Risk,456,460,4,4
4/1/2016,Low Risk,158,200,42,6
4/2/2016,Low Risk,186,235,49,50
4/13/2016,High Risk,-96,336,432,306
4/13/2016,Low Risk,75,146,71,63
4/8/2016,Low Risk,0,48,48,10
4/13/2016,High Risk,486,644,158,172
4/8/2016,Low Risk,0,46,46,13
4/14/2016,Low Risk,109,183,74,71
3/18/2016,Low Risk,448,495,47,47
4/16/2016,High Risk,-43,146,189,183
4/14/2016,High Risk,104,145,41,40
4/5/2016,Low Risk,0,42,42,13
4/26/2016,Low Risk,-1,163,164,164
9/12/2015,Low Risk,149,222,73,73
4/11/2016,Low Risk,0,64,64,4
4/12/2016,Low Risk,0,31,31,11
4/14/2016,Low Risk,0,71,71,11
4/25/2016,High Risk,86,170,84,79
4/28/2016,Low Risk,150,181,31,31
4/22/2016,Low Risk,285,308,23,23
4/22/2016,Low Risk,36,188,152,11
5/13/2016,Low Risk,0,32,32,11
3/1/2016,Low Risk,262,295,33,33
4/23/2016,Low Risk,323,353,30,12
4/21/2016,Low Risk,135,152,17,17
3/31/2016,Low Risk,274,349,75,4
5/5/2016,Low Risk,130,174,44,42
4/6/2016,High Risk,132,253,121,114
4/19/2016,Low Risk,104,177,73,71
5/3/2016,Low Risk,90,94,4,4
5/4/2016,Low Risk,179,209,30,30
4/13/2016,Low Risk,204,245,41,4
4/7/2016,Low Risk,158,210,52,52
5/3/2016,Low Risk,64,119,55,10
4/19/2016,Low Risk,-6,37,43,14
5/2/2016,Low Risk,0,24,24,11
5/10/2016,Low Risk,148,188,40,40
4/15/2016,Low Risk,0,76,76,29
4/27/2016,High Risk,-1,280,281,262
5/7/2016,Low Risk,152,192,40,40
3/21/2016,Low Risk,267,312,45,43
5/10/2016,High Risk,90,259,169,148
5/13/2016,Low Risk,0,33,33,4
5/9/2016,Low Risk,0,37,37,4
4/8/2016,Low Risk,210,249,39,39
5/18/2016,High Risk,-36,364,400,348
5/18/2016,Low Risk,52,124,72,9
5/16/2016,High Risk,-395,-97,298,38
5/5/2016,Low Risk,248,371,123,14
5/13/2016,Low Risk,540,549,9,9
4/17/2016,High Risk,128,185,57,44
4/26/2016,Low Risk,280,288,8,8
4/19/2016,Low Risk,-17,52,69,12
3/24/2016,High Risk,134,300,166,180
3/21/2016,High Risk,126,220,94,92
5/16/2016,Low Risk,45,119,74,28
5/21/2016,High Risk,73,282,209,270
5/20/2016,High Risk,254,262,8,32
5/7/2016,Low Risk,156,221,65,65
5/16/2016,Low Risk,332,358,26,26
5/24/2016,Low Risk,261,272,11,11
1/20/2016,Low Risk,68,231,163,157
4/14/2016,Low Risk,120,167,47,47
6/7/2016,Low Risk,175,227,52,52
2/23/2016,High Risk,187,377,190,166
6/7/2016,Low Risk,219,266,47,47
5/24/2016,High Risk,159,449,290,212
6/8/2016,Low Risk,229,245,16,16
6/17/2016,High Risk,49,215,166,61
6/13/2016,Low Risk,28,35,7,7
6/23/2016,Low Risk,108,146,38,38
6/1/2016,High Risk,63,141,78,76
4/18/2016,Low Risk,65,91,26,26
4/19/2016,Low Risk,65,92,27,27
2/4/2016,High Risk,57,953,896,246
6/19/2016,Low Risk,69,96,27,36
6/11/2016,Low Risk,345,352,7,7
6/23/2016,Low Risk,114,195,81,55
6/13/2016,Low Risk,279,304,25,13
7/4/2016,Low Risk,0,15,15,15
5/20/2016,Low Risk,46,70,24,24
7/5/2016,Low Risk,54,83,29,29
6/12/2016,High Risk,349,403,54,399
7/2/2016,Low Risk,10,40,30,30
1/23/2016,Low Risk,163,188,25,25
6/29/2016,Low Risk,177,252,75,75
6/29/2016,Low Risk,6,259,253,253
6/21/2016,Low Risk,185,251,66,9
6/1/2016,Low Risk,87,155,68,66
6/25/2016,Low Risk,72,86,14,14
7/1/2016,Low Risk,80,102,22,22
7/4/2016,Low Risk,86,122,36,17
7/11/2016,Low Risk,0,30,30,20
6/2/2016,Low Risk,0,77,77,20
7/1/2016,Low Risk,0,69,69,10
7/6/2016,Low Risk,0,63,63,15
7/5/2016,Low Risk,363,427,64,23
7/7/2016,Low Risk,109,151,42,42
7/12/2016,Low Risk,0,57,57,6
6/30/2016,High Risk,42,124,82,77
7/20/2016,Low Risk,108,202,94,94
6/25/2016,Low Risk,222,240,18,18
7/17/2016,Low Risk,0,52,52,10
7/13/2016,Low Risk,0,57,57,28
5/20/2016,Low Risk,520,552,32,32
4/29/2016,Low Risk,0,143,143,9
7/22/2016,Low Risk,0,103,103,23
7/7/2016,High Risk,111,361,250,64
7/21/2016,High Risk,201,301,100,95
7/14/2016,High Risk,104,455,351,193
7/30/2016,Low Risk,0,66,66,16
7/12/2016,Low Risk,78,87,9,9
7/21/2016,Low Risk,0,47,47,6
7/25/2016,High Risk,59,101,42,26
7/24/2016,Low Risk,64,110,46,46
8/1/2016,High Risk,52,165,113,105
7/23/2016,Low Risk,177,208,31,31
7/29/2016,Low Risk,0,68,68,4
7/22/2016,Low Risk,224,299,75,75
8/2/2016,Low Risk,40,218,178,174
8/13/2016,Low Risk,68,74,6,6
7/29/2016,High Risk,-2453,214,2667,70
8/3/2016,Legal Case,-14,356,370,281
8/4/2016,Low Risk,0,33,33,5
7/27/2016,Low Risk,276,285,9,9
8/11/2016,High Risk,81,202,121,118
8/6/2016,Low Risk,0,72,72,8
8/5/2016,Low Risk,0,32,32,4
7/29/2016,Low Risk,87,123,36,36
7/30/2016,High Risk,98,271,173,138
8/1/2016,Low Risk,0,36,36,10
8/15/2016,High Risk,66,213,147,121
8/2/2016,High Risk,305,378,73,70
7/19/2016,Low Risk,242,519,277,268
8/5/2016,High Risk,76,136,60,58
8/2/2016,High Risk,142,219,77,115
8/1/2016,Low Risk,37,109,72,55
8/4/2016,Low Risk,190,222,32,32
8/8/2016,Low Risk,138,213,75,71
6/14/2016,Low Risk,47,77,30,30
6/18/2016,Low Risk,60,73,13,13
6/30/2016,Low Risk,60,98,38,38
8/13/2016,Low Risk,0,26,26,21
8/19/2016,Low Risk,108,333,225,53
8/28/2016,Low Risk,0,32,32,8
8/15/2016,Low Risk,111,234,123,120
3/26/2016,Low Risk,542,607,65,65
8/25/2016,Low Risk,0,33,33,10
7/20/2016,Low Risk,40,48,8,8
8/15/2016,High Risk,-250,144,394,153
8/12/2016,Low Risk,79,145,66,44
7/29/2016,Low Risk,101,117,16,16
8/6/2016,High Risk,110,332,222,194
7/29/2016,Low Risk,298,367,69,44
7/26/2016,Low Risk,727,771,44,45
8/22/2016,Low Risk,0,22,22,5
8/17/2016,Low Risk,0,37,37,12
8/20/2016,Low Risk,52,100,48,12
8/15/2016,Low Risk,119,169,50,50
8/19/2016,Low Risk,118,187,69,28
8/17/2016,Low Risk,0,44,44,10
8/17/2016,High Risk,-8,130,138,131
8/12/2016,High Risk,-2,159,161,148
8/25/2016,Low Risk,0,28,28,11
8/31/2016,Low Risk,0,22,22,8
8/22/2016,Low Risk,85,121,36,36
7/26/2016,Low Risk,244,253,9,9
8/25/2016,Low Risk,-11,385,396,72
8/23/2016,Low Risk,64,91,27,27
8/3/2016,Low Risk,0,82,82,8
9/1/2016,Low Risk,127,231,104,35
8/22/2016,Low Risk,57,63,6,6
8/15/2016,Low Risk,0,112,112,5
8/27/2016,Low Risk,0,27,27,9
8/30/2016,High Risk,70,113,43,39
8/23/2016,Low Risk,0,66,66,8
9/5/2016,Low Risk,0,17,17,27
8/30/2016,Low Risk,386,520,134,134
8/25/2016,Low Risk,35,145,110,15
8/29/2016,Low Risk,474,522,48,48
9/14/2016,Low Risk,0,33,33,5
9/5/2016,Low Risk,0,72,72,6
9/18/2016,Low Risk,228,278,50,50
9/17/2016,Low Risk,115,187,72,72
6/26/2016,High Risk,197,375,178,71
8/29/2016,High Risk,-46,381,427,370
8/27/2016,Low Risk,301,321,20,20
9/19/2016,Low Risk,0,28,28,13
9/7/2016,High Risk,3,254,251,109
8/29/2016,High Risk,77,346,269,259
8/26/2016,High Risk,30,258,228,91
9/15/2016,High Risk,168,302,134,129
9/19/2016,Low Risk,238,246,8,8
9/20/2016,High Risk,298,405,107,90
9/3/2016,Low Risk,68,163,95,22
9/26/2016,High Risk,115,269,154,141
7/22/2016,Low Risk,146,196,50,50
8/21/2016,High Risk,91,215,124,56
9/24/2016,Low Risk,0,26,26,8
9/21/2016,Low Risk,0,21,21,6
9/20/2016,Low Risk,0,35,35,29
9/27/2016,Low Risk,133,210,77,77
9/20/2016,Low Risk,84,204,120,116
6/3/2016,Low Risk,420,451,31,31
9/12/2016,Low Risk,634,674,40,40
9/19/2016,Low Risk,30,38,8,8
9/30/2016,Low Risk,186,229,43,40
9/23/2016,Low Risk,24,110,86,84
8/30/2016,Low Risk,341,367,26,36
5/14/2016,Low Risk,335,369,34,34
9/16/2016,Low Risk,251,271,20,20
8/25/2016,Low Risk,351,364,13,13
9/23/2016,High Risk,0,312,312,232
9/26/2016,Low Risk,12,70,58,20
9/25/2016,Low Risk,31,141,110,15
9/28/2016,Low Risk,71,105,34,34
9/28/2016,Low Risk,0,49,49,8
10/5/2016,High Risk,57,106,49,47
9/29/2016,Low Risk,146,158,12,12
10/7/2016,Low Risk,158,180,22,22
10/6/2016,Low Risk,0,22,22,7
8/26/2016,Low Risk,62,112,50,47
10/24/2016,Low Risk,8,88,80,68
9/10/2016,Low Risk,108,122,14,14
10/6/2016,High Risk,238,606,368,239
10/20/2016,Low Risk,113,127,14,14
7/22/2016,High Risk,123,322,199,175
9/15/2016,Low Risk,0,67,67,8
10/15/2016,Low Risk,0,23,23,4
10/17/2016,Low Risk,0,49,49,27
10/6/2016,Low Risk,279,293,14,14
10/18/2016,Low Risk,376,393,17,17
10/22/2016,Low Risk,0,27,27,4
10/12/2016,Low Risk,24,34,10,10
11/6/2016,Low Risk,0,134,134,13
10/25/2016,Low Risk,101,113,12,12
10/11/2016,High Risk,110,435,325,303
10/25/2016,Low Risk,540,568,28,15
9/29/2016,Low Risk,15,77,62,10
9/19/2016,High Risk,101,367,266,241
10/5/2016,Low Risk,78,126,48,19
10/11/2016,Low Risk,238,266,28,28
10/27/2016,Low Risk,91,166,75,64
11/1/2016,Low Risk,7,357,350,40
10/29/2016,High Risk,-8,165,173,157
10/20/2016,Low Risk,0,34,34,15
11/5/2016,Low Risk,0,62,62,9
10/24/2016,Low Risk,0,57,57,12
10/31/2016,Low Risk,45,123,78,10
11/7/2016,Low Risk,258,276,18,14
11/23/2016,Low Risk,0,44,44,4
10/4/2016,Low Risk,49,63,14,14
11/11/2016,Low Risk,0,39,39,4
11/8/2016,Low Risk,0,36,36,4
11/11/2016,High Risk,-177,551,728,95
10/9/2016,Low Risk,56,180,124,24
10/7/2016,Low Risk,87,91,4,4
10/7/2016,Low Risk,0,61,61,12
11/16/2016,Low Risk,0,21,21,6
11/7/2016,Low Risk,0,38,38,11
11/4/2016,Low Risk,0,33,33,8
11/12/2016,Low Risk,0,59,59,7
11/10/2016,Low Risk,141,190,49,49
11/8/2016,Low Risk,104,126,22,22
9/25/2016,Low Risk,37,71,34,34
9/27/2016,Low Risk,90,115,25,25
11/9/2016,Low Risk,0,50,50,22
11/17/2016,Low Risk,195,210,15,15
11/10/2016,High Risk,105,273,168,355
10/20/2016,Low Risk,129,168,39,55
11/24/2016,Low Risk,5,13,8,8
11/21/2016,Low Risk,560,582,22,8
11/26/2016,High Risk,372,405,33,37
11/17/2016,Low Risk,0,27,27,8
11/7/2016,Low Risk,0,43,43,9
11/27/2016,High Risk,119,191,72,67
11/7/2016,Low Risk,0,60,60,10
11/18/2016,Low Risk,88,157,69,8
11/28/2016,Low Risk,172,270,98,131
11/15/2016,Low Risk,60,133,73,20
10/25/2016,High Risk,24,213,189,78
5/5/2016,High Risk,105,190,85,146
11/26/2016,Low Risk,0,76,76,27
11/20/2016,High Risk,-32,253,285,220
11/16/2016,Low Risk,94,197,103,13
11/22/2016,Low Risk,29,358,329,234
11/28/2016,Low Risk,66,74,8,8
11/30/2016,Low Risk,137,174,37,34
11/28/2016,Low Risk,161,194,33,33
12/7/2016,Low Risk,-1,64,65,7
12/1/2016,High Risk,179,480,301,173
12/9/2016,Low Risk,0,95,95,12
12/6/2016,Low Risk,8,282,274,274
11/19/2016,High Risk,75,151,76,71
11/28/2016,Low Risk,0,57,57,10
12/3/2016,Low Risk,141,185,44,31
12/12/2016,Low Risk,16,52,36,20
12/8/2016,Low Risk,0,41,41,10
12/3/2016,Legal Case,146,229,83,180
12/8/2016,Low Risk,-9,20,29,6
10/21/2016,High Risk,359,502,143,103
12/6/2016,Low Risk,31,73,42,8
12/8/2016,Low Risk,0,49,49,8
11/11/2016,High Risk,211,383,172,372
12/24/2016,Low Risk,64,144,80,28
12/13/2016,Low Risk,0,72,72,30
10/6/2016,Low Risk,352,358,6,6
11/28/2016,Low Risk,55,108,53,16
12/15/2016,Low Risk,-1,286,287,278
1/5/2017,High Risk,-8,259,267,198
12/19/2016,High Risk,-113,569,682,441
11/26/2016,High Risk,-21,93,114,98
12/28/2016,Low Risk,149,175,26,40
12/26/2016,High Risk,82,129,47,42
12/29/2016,High Risk,78,148,70,70
12/14/2016,Low Risk,235,321,86,111
12/14/2016,Low Risk,202,264,62,62
11/17/2016,Low Risk,0,98,98,14
11/27/2016,Low Risk,256,283,27,27
11/13/2016,High Risk,444,445,1,228
12/28/2016,Low Risk,167,217,50,17
12/29/2016,High Risk,154,265,111,68
12/22/2016,High Risk,204,225,21,20
12/26/2016,High Risk,59,119,60,56
1/11/2017,Low Risk,0,14,14,9
12/20/2016,Low Risk,663,722,59,51
1/7/2017,Low Risk,8,16,8,8
1/18/2017,Low Risk,138,196,58,18
1/6/2017,Low Risk,1636,1642,6,6
1/5/2017,Low Risk,0,20,20,9
1/3/2017,Low Risk,0,59,59,9
10/31/2016,Low Risk,175,200,25,25
1/6/2017,Low Risk,140,188,48,19
1/4/2017,Low Risk,95,138,43,12
1/27/2017,Low Risk,141,356,215,215
10/15/2016,Low Risk,311,478,167,4
11/16/2016,Low Risk,201,336,135,7
11/13/2016,Low Risk,458,523,65,37
11/17/2016,Low Risk,75,82,7,7
1/3/2017,High Risk,165,255,90,147
1/27/2017,High Risk,493,640,147,58
1/6/2017,High Risk,86,244,158,153
1/18/2017,Low Risk,162,266,104,101
1/9/2017,Low Risk,0,63,63,23
1/18/2017,Low Risk,0,47,47,4
1/19/2017,Low Risk,0,47,47,9
1/16/2017,High Risk,205,280,75,83
1/29/2017,High Risk,528,571,43,438
1/23/2017,Low Risk,460,464,4,4
1/19/2017,High Risk,217,258,41,36
11/25/2016,High Risk,199,528,329,124
1/13/2017,Low Risk,274,290,16,16
1/6/2017,Low Risk,0,77,77,12
12/13/2016,High Risk,400,518,118,108
1/15/2017,Low Risk,35,61,26,6
2/3/2017,Low Risk,30,69,39,12
1/29/2017,Low Risk,15,163,148,138
1/23/2017,High Risk,83,107,24,32
1/20/2017,Low Risk,246,283,37,37
1/30/2017,Legal Case,606,662,56,325
1/25/2017,Low Risk,78,140,62,13
2/7/2017,Low Risk,203,245,42,18
2/2/2017,Low Risk,0,39,39,5
1/14/2017,Low Risk,112,160,48,49
12/1/2016,Low Risk,483,614,131,148
2/11/2017,Low Risk,42,75,33,8
1/17/2017,Legal Case,91,148,57,38
1/27/2017,Low Risk,57,249,192,12
10/18/2016,Legal Case,289,464,175,8
1/30/2017,Legal Case,59,710,651,530
1/4/2017,Low Risk,164,261,97,18
12/30/2016,Low Risk,45,147,102,18
12/3/2016,Low Risk,128,138,10,10
1/21/2017,High Risk,6,278,272,257
1/18/2017,High Risk,543,723,180,446
2/1/2017,Low Risk,26,97,71,10
1/31/2017,Low Risk,156,190,34,4
2/4/2017,Low Risk,122,181,59,58
2/2/2017,Low Risk,43,76,33,23
2/6/2017,High Risk,40,120,80,79
2/7/2017,Low Risk,35,72,37,12
12/12/2016,High Risk,544,681,137,99
2/5/2017,High Risk,75,262,187,173
1/14/2017,Low Risk,0,52,52,8
12/18/2016,Low Risk,0,173,173,5
2/10/2017,Low Risk,48,75,27,12
2/13/2017,Low Risk,35,56,21,19
1/30/2017,Low Risk,273,282,9,9
1/5/2017,High Risk,142,344,202,192
1/21/2017,High Risk,410,475,65,511
1/23/2017,Low Risk,29,80,51,4
2/7/2017,Low Risk,125,155,30,19
2/13/2017,Low Risk,15,58,43,8
9/12/2016,Low Risk,192,213,21,38
2/24/2017,Low Risk,0,12,12,5
2/13/2017,Low Risk,105,163,58,25
1/27/2017,Low Risk,111,159,48,7
2/7/2017,High Risk,46,223,177,151
2/18/2017,High Risk,219,368,149,148
12/24/2016,Low Risk,578,804,226,25
2/10/2017,High Risk,21,216,195,66
1/17/2017,Low Risk,72,83,11,11
1/21/2017,Low Risk,248,319,71,71
2/8/2017,High Risk,667,693,26,578
2/11/2017,Low Risk,124,144,20,20
2/20/2017,Low Risk,117,135,18,18
12/20/2016,Low Risk,138,148,10,10
2/7/2017,High Risk,90,127,37,32
12/30/2016,High Risk,281,476,195,322
2/23/2017,Low Risk,29,71,42,8
2/28/2017,Low Risk,41,56,15,11
2/16/2017,High Risk,330,568,238,41
3/4/2017,Low Risk,32,69,37,8
2/20/2017,High Risk,47,240,193,15
2/17/2017,Legal Case,-20,516,536,638
2/21/2017,Low Risk,40,70,30,13
2/20/2017,High Risk,171,378,207,82
2/18/2017,Low Risk,25,94,69,17
12/12/2016,Low Risk,82,95,13,13
1/31/2017,Low Risk,106,189,83,10
3/5/2017,Low Risk,159,208,49,49
2/17/2017,High Risk,-1101,-928,173,69
1/22/2017,High Risk,145,493,348,41
3/6/2017,Low Risk,92,155,63,19
1/14/2017,Low Risk,0,75,75,28
3/14/2017,Low Risk,26,69,43,4
3/7/2017,High Risk,103,139,36,63
2/28/2017,Low Risk,43,71,28,4
2/27/2017,Low Risk,45,74,29,10
3/10/2017,Low Risk,58,73,15,15
12/20/2016,Low Risk,190,195,5,5
3/9/2017,Low Risk,21,64,43,19
3/8/2017,High Risk,627,765,138,234
2/21/2017,Low Risk,100,143,43,11
2/10/2017,Low Risk,26,87,61,10
2/17/2017,Low Risk,128,167,39,35
2/26/2017,Low Risk,0,71,71,9
3/10/2017,Low Risk,364,390,26,14
3/6/2017,Low Risk,66,79,13,13
3/9/2017,Low Risk,120,148,28,14
1/20/2017,Low Risk,131,201,70,12
3/6/2017,High Risk,73,290,217,210
2/28/2017,Low Risk,245,254,9,9
3/25/2017,Low Risk,49,79,30,14
3/6/2017,Low Risk,109,137,28,16
3/1/2017,Low Risk,72,281,209,31
3/13/2017,Low Risk,102,158,56,21
3/1/2017,High Risk,84,161,77,95
2/20/2017,High Risk,-48,164,212,194
3/23/2017,High Risk,30,139,109,117
3/6/2017,High Risk,467,583,116,109
3/13/2017,Low Risk,15,57,42,15
3/2/2017,Low Risk,8,63,55,10
3/2/2017,Low Risk,86,160,74,74
1/21/2017,Legal Case,921,996,75,373
2/26/2017,Legal Case,238,464,226,377
3/17/2017,Low Risk,49,69,20,8
4/2/2017,Low Risk,34,71,37,7
12/30/2016,High Risk,141,516,375,17
3/20/2017,High Risk,108,262,154,136
3/25/2017,Low Risk,140,173,33,22
3/12/2017,Low Risk,6,64,58,9
3/15/2017,Low Risk,14,57,43,4
3/18/2017,High Risk,-94,310,404,302
3/9/2017,Low Risk,650,671,21,21
3/23/2017,Low Risk,29,69,40,4
3/15/2017,Low Risk,39,345,306,306
3/8/2017,Low Risk,0,55,55,7
3/8/2017,High Risk,57,245,188,67
2/27/2017,High Risk,58,163,105,104
3/27/2017,Low Risk,66,108,42,16
3/17/2017,Low Risk,91,137,46,26
3/16/2017,Low Risk,85,132,47,8
3/17/2017,Low Risk,128,137,9,9
4/14/2017,Low Risk,87,126,39,37
3/16/2017,High Risk,136,329,193,189
3/16/2017,Low Risk,21,82,61,16
7/18/2016,High Risk,-173,380,553,55
3/22/2017,High Risk,106,238,132,128
3/20/2017,Low Risk,93,136,43,43
3/21/2017,High Risk,235,359,124,87
4/7/2017,Low Risk,61,73,12,12
4/7/2017,Low Risk,99,126,27,38
4/5/2017,High Risk,357,447,90,212
4/3/2017,Low Risk,216,401,185,185
4/15/2017,Low Risk,11,62,51,22
4/13/2017,High Risk,190,250,60,58
4/5/2017,Low Risk,200,223,23,13
3/20/2017,High Risk,121,240,119,112
4/3/2017,Low Risk,13,72,59,8
3/4/2017,Legal Case,58,187,129,485
3/28/2017,High Risk,49,175,126,116
3/15/2017,Low Risk,139,149,10,39
3/20/2017,Low Risk,136,144,8,8
4/8/2017,High Risk,219,307,88,53
4/7/2017,Low Risk,105,206,101,98
2/19/2017,Low Risk,4,278,274,274
3/27/2017,Low Risk,361,389,28,28
4/19/2017,Low Risk,97,147,50,50
4/22/2017,Low Risk,26,66,40,12
3/27/2017,Low Risk,217,136,-81,48
4/10/2017,Low Risk,18,74,56,14
4/21/2017,Low Risk,67,112,45,4
3/29/2017,High Risk,253,413,160,222
1/22/2017,Legal Case,265,368,103,209
4/23/2017,Low Risk,52,68,16,7
4/23/2017,Low Risk,126,135,9,9
4/17/2017,Low Risk,97,141,44,57
4/21/2017,Low Risk,30,159,129,18
4/11/2017,Low Risk,229,326,97,22
5/9/2017,Low Risk,23,64,41,5
4/25/2017,Low Risk,215,233,18,18
4/27/2017,High Risk,168,175,7,44
4/20/2017,Low Risk,36,169,133,9
3/2/2017,Low Risk,279,459,180,114
4/8/2017,Low Risk,108,170,62,62
4/17/2017,Low Risk,0,73,73,18
5/3/2017,Low Risk,124,154,30,30
5/6/2017,Low Risk,75,130,55,55
4/15/2017,Low Risk,508,517,9,9
4/19/2017,Low Risk,0,51,51,25
4/21/2017,Low Risk,0,89,89,14
4/30/2017,Low Risk,148,232,84,84
5/8/2017,Low Risk,32,144,112,8
5/9/2017,Low Risk,390,360,-30,106
4/25/2017,Low Risk,19,76,57,7
4/21/2017,High Risk,1551,1652,101,124
4/9/2017,Low Risk,126,219,93,4
5/10/2017,Low Risk,122,141,19,19
5/9/2017,Low Risk,113,156,43,42
1/27/2017,Low Risk,239,518,279,28
4/7/2017,High Risk,1264,1550,286,701
5/3/2017,Low Risk,119,125,6,6
5/5/2017,Low Risk,18,70,52,4
5/13/2017,Low Risk,33,60,27,7
4/3/2017,High Risk,76,170,94,90
5/16/2017,High Risk,1035,1140,105,622
5/16/2017,Low Risk,114,169,55,22
5/13/2017,Low Risk,124,220,96,96
4/22/2017,Low Risk,200,292,92,51
5/19/2017,Low Risk,78,210,132,124
5/9/2017,Low Risk,21,58,37,15
7/5/2016,Low Risk,249,323,74,74
5/17/2017,High Risk,194,439,245,208
5/24/2017,Low Risk,0,34,34,7
5/23/2017,High Risk,67,129,62,61
6/4/2017,High Risk,236,248,12,31
5/15/2017,Low Risk,32,74,42,9
5/12/2017,Low Risk,63,98,35,9
5/15/2017,Low Risk,132,220,88,88
5/4/2017,Low Risk,46,82,36,9
5/17/2017,Low Risk,0,114,114,9
5/24/2017,Low Risk,93,152,59,59
4/24/2017,High Risk,156,387,231,224
5/5/2017,High Risk,265,486,221,221
5/22/2017,High Risk,279,378,99,96
5/13/2017,Low Risk,206,214,8,8
5/26/2017,Low Risk,63,68,5,5
4/28/2017,High Risk,377,642,265,270
5/26/2017,Low Risk,349,459,110,9
5/18/2017,High Risk,111,181,70,62
5/18/2017,Low Risk,39,78,39,27
5/29/2017,Low Risk,35,63,28,20
5/26/2017,High Risk,126,228,102,131
5/23/2017,Low Risk,0,27,27,15
1/5/2017,High Risk,241,463,222,161
5/24/2017,Low Risk,464,497,33,34
6/11/2017,Low Risk,104,120,16,16
3/23/2017,Low Risk,156,217,61,60
3/23/2017,Low Risk,59,217,158,10
3/9/2017,Low Risk,59,231,172,28
3/20/2017,Low Risk,96,251,155,139
5/31/2017,Low Risk,38,65,27,10
10/31/2016,Low Risk,337,352,15,15
5/22/2017,High Risk,436,471,35,56
6/5/2017,Low Risk,39,71,32,7
6/6/2017,Low Risk,22,66,44,21
6/10/2017,Low Risk,89,130,41,21
6/7/2017,Low Risk,28,71,43,17
6/15/2017,Low Risk,0,14,14,10
6/16/2017,Low Risk,34,68,34,7
5/29/2017,Low Risk,329,435,106,104
6/14/2017,Low Risk,23,58,35,26
6/29/2017,Low Risk,0,104,104,4
5/6/2017,Low Risk,0,75,75,8
6/12/2017,Low Risk,34,70,36,9
6/13/2017,High Risk,117,568,451,377
6/19/2017,Low Risk,245,296,51,51
7/10/2017,Low Risk,0,93,93,8
6/1/2017,Low Risk,266,285,19,19
6/21/2017,Low Risk,39,75,36,15
6/22/2017,Low Risk,43,76,33,9
5/19/2017,Low Risk,1,70,69,26
6/23/2017,Low Risk,137,145,8,8
6/20/2017,Low Risk,141,176,35,35
6/19/2017,Low Risk,40,71,31,18
6/18/2017,Low Risk,351,405,54,38
6/16/2017,Low Risk,116,175,59,59
6/24/2017,High Risk,64,258,194,188
7/6/2017,Low Risk,11,39,28,4
7/4/2017,Low Risk,329,398,69,69
7/12/2017,High Risk,119,180,61,61
7/6/2017,Low Risk,58,78,20,25
7/5/2017,Low Risk,43,64,21,15
7/10/2017,Low Risk,190,214,24,9
7/11/2017,Low Risk,56,72,16,8
6/28/2017,Low Risk,178,190,12,12
5/3/2017,High Risk,-34,651,685,299
7/10/2017,Low Risk,58,241,183,170
6/17/2017,High Risk,91,235,144,140
6/7/2017,Low Risk,0,56,56,8
7/18/2017,Low Risk,102,136,34,5
7/10/2017,Low Risk,106,137,31,8
7/10/2017,Low Risk,0,85,85,8
7/8/2017,Low Risk,148,194,46,39
7/10/2017,Low Risk,20,66,46,10
7/12/2017,Low Risk,51,79,28,28
7/14/2017,Low Risk,33,66,33,10
7/17/2017,Low Risk,577,583,6,6
7/24/2017,Low Risk,127,142,15,14
7/14/2017,Low Risk,22,75,53,7
7/22/2017,Low Risk,-20,249,269,70
7/12/2017,Low Risk,205,310,105,17
7/24/2017,Low Risk,142,157,15,15
7/4/2017,High Risk,99,170,71,68
7/16/2017,Low Risk,24,82,58,4
7/12/2017,Low Risk,439,478,39,39
7/12/2017,Low Risk,288,337,49,19
7/26/2017,Low Risk,101,142,41,41
7/9/2017,High Risk,423,437,14,163
7/28/2017,Low Risk,57,77,20,8
6/21/2017,Legal Case,-54,267,321,1288
8/1/2017,Low Risk,102,175,73,21
7/25/2017,Low Risk,38,76,38,11
7/27/2017,Low Risk,41,81,40,15
7/4/2017,Low Risk,70,154,84,41
8/1/2017,Low Risk,41,71,30,14
7/28/2017,Low Risk,53,87,34,10
8/13/2017,Low Risk,8,152,144,9
7/11/2017,Legal Case,99,289,190,389
7/10/2017,Low Risk,7,80,73,25
8/18/2017,High Risk,126,334,208,200
8/4/2017,Low Risk,37,75,38,8
8/12/2017,Low Risk,37,68,31,5
8/10/2017,High Risk,116,165,49,57
8/11/2017,Low Risk,114,153,39,39
8/5/2017,Low Risk,46,76,30,24
6/17/2017,Low Risk,128,215,87,88
7/31/2017,High Risk,72,766,694,97
7/27/2017,Low Risk,275,312,37,44
8/13/2017,Low Risk,0,18,18,5
8/16/2017,High Risk,309,672,363,218
8/8/2017,Low Risk,48,72,24,10
8/4/2017,Low Risk,44,75,31,4
7/28/2017,Low Risk,36,81,45,7
8/2/2017,Low Risk,327,344,17,17
5/2/2017,High Risk,-6,337,343,187
8/14/2017,High Risk,107,151,44,43
8/9/2017,Low Risk,70,105,35,17
8/28/2017,High Risk,-94,1447,1541,706
8/8/2017,Low Risk,78,150,72,23
8/5/2017,Low Risk,386,408,22,22
6/18/2017,High Risk,39,260,221,17
8/27/2017,Low Risk,50,152,102,10
8/8/2017,Low Risk,192,197,5,5
8/17/2017,Low Risk,120,153,33,33
8/11/2017,Low Risk,202,363,161,5
8/11/2017,Low Risk,7,81,74,5
8/15/2017,Low Risk,30,73,43,9
8/13/2017,Low Risk,57,86,29,8
7/26/2017,High Risk,2272,2310,38,38
8/18/2017,Low Risk,53,154,101,25
8/6/2017,High Risk,116,299,183,194
8/20/2017,Low Risk,120,135,15,15
7/28/2017,High Risk,369,414,45,42
7/22/2017,Low Risk,1,103,102,8
8/19/2017,Low Risk,22,75,53,14
8/27/2017,Low Risk,140,149,9,9
8/24/2017,Low Risk,181,330,149,143
7/1/2017,High Risk,-1,691,692,511
7/19/2017,Low Risk,228,273,45,42
8/20/2017,Low Risk,86,152,66,66
8/7/2017,Low Risk,159,240,81,14
7/18/2017,High Risk,35,163,128,189
8/31/2017,Low Risk,130,155,25,19
8/22/2017,Low Risk,138,150,12,12
8/12/2017,High Risk,96,312,216,158
8/4/2017,High Risk,89,180,91,104
9/8/2017,Low Risk,187,194,7,7
8/28/2017,Low Risk,52,94,42,16
8/27/2017,Low Risk,33,73,40,13
8/21/2017,High Risk,341,541,200,480
8/27/2017,Low Risk,343,464,121,73
8/23/2017,Low Risk,223,329,106,106
7/18/2017,Low Risk,20,289,269,18
6/13/2017,Low Risk,150,282,132,21
9/4/2017,Low Risk,0,93,93,12
7/7/2017,Low Risk,50,131,81,4
5/18/2017,Low Risk,112,182,70,68
5/19/2017,Low Risk,28,181,153,10
6/12/2017,Low Risk,99,185,86,85
9/14/2017,Low Risk,123,244,121,121
9/1/2017,Low Risk,14,76,62,10
8/17/2017,Low Risk,7,84,77,10
9/5/2017,Low Risk,131,316,185,178
8/31/2017,Low Risk,20,82,62,18
9/6/2017,Low Risk,18,82,64,15
9/12/2017,Low Risk,73,163,90,9
9/20/2017,Low Risk,202,279,77,74
9/25/2017,Low Risk,120,149,29,29
9/13/2017,Low Risk,218,268,50,11
9/11/2017,Low Risk,32,78,46,13
9/19/2017,High Risk,93,338,245,182
9/25/2017,Low Risk,126,267,141,7
9/27/2017,Low Risk,55,70,15,4
9/20/2017,Low Risk,92,176,84,8
9/30/2017,Low Risk,129,137,8,8
9/23/2017,High Risk,-18,182,200,681
9/18/2017,Low Risk,42,85,43,13
10/1/2017,Low Risk,39,71,32,12
10/1/2017,High Risk,123,269,146,146
9/20/2017,Low Risk,43,84,41,22
10/6/2017,Low Risk,40,67,27,8
10/5/2017,Low Risk,2,18,16,16
9/23/2017,High Risk,216,527,311,449
10/4/2017,Low Risk,47,75,28,7
9/23/2017,Low Risk,242,270,28,45
9/17/2017,Legal Case,-112,425,537,220
9/30/2017,Low Risk,130,144,14,14
9/28/2017,Low Risk,153,168,15,15
9/28/2017,Low Risk,133,140,7,7
9/24/2017,Low Risk,226,234,8,8
9/28/2017,Low Risk,121,161,40,40
8/22/2017,Low Risk,75,154,79,19
9/24/2017,Low Risk,141,236,95,11
10/9/2017,Low Risk,42,73,31,9
8/30/2017,High Risk,362,581,219,495
9/29/2017,High Risk,197,264,67,64
10/7/2017,Low Risk,0,73,73,4
10/21/2017,Low Risk,431,438,7,7
10/16/2017,Low Risk,227,233,6,6
5/30/2017,Low Risk,139,155,16,16
9/27/2017,Low Risk,9,141,132,6
10/20/2017,Low Risk,139,285,146,17
8/4/2017,Low Risk,0,136,136,9
10/12/2017,Low Risk,35,84,49,17
10/12/2017,High Risk,97,217,120,117
10/17/2017,Low Risk,0,65,65,24
10/26/2017,Low Risk,36,75,39,9
7/9/2017,Low Risk,143,150,7,7
10/14/2017,Low Risk,0,66,66,20
10/12/2017,Low Risk,20,76,56,15
10/26/2017,Low Risk,35,77,42,9
11/4/2017,High Risk,122,166,44,44
10/31/2017,High Risk,260,281,21,297
10/30/2017,Low Risk,274,324,50,50
10/29/2017,High Risk,15,240,225,186
8/22/2017,Low Risk,282,324,42,41
10/11/2017,High Risk,511,609,98,85
7/13/2017,Low Risk,0,239,239,12
10/17/2017,High Risk,160,646,486,398
11/1/2017,High Risk,299,348,49,79
10/6/2017,Low Risk,46,105,59,6
6/27/2017,Low Risk,145,156,11,11
10/27/2017,High Risk,104,166,62,61
11/4/2017,Low Risk,238,247,9,9
10/24/2017,Low Risk,0,211,211,4
10/21/2017,Low Risk,150,236,86,6
10/11/2017,High Risk,154,258,104,86
11/7/2017,High Risk,121,303,182,360
10/15/2017,Low Risk,0,44,44,15
10/22/2017,Low Risk,0,82,82,4
11/8/2017,High Risk,105,197,92,90
10/24/2017,Low Risk,109,181,72,8
11/1/2017,Low Risk,23,72,49,10
11/8/2017,Low Risk,0,64,64,14
9/7/2017,Low Risk,0,91,91,14
11/11/2017,Low Risk,0,27,27,28
8/27/2017,Low Risk,373,443,70,66
9/7/2017,High Risk,281,391,110,58
7/17/2017,Legal Case,352,710,358,278
11/7/2017,Low Risk,31,73,42,4
11/13/2017,Low Risk,34,79,45,18
11/13/2017,High Risk,264,303,39,38
11/13/2017,Low Risk,475,512,37,11
10/14/2017,Low Risk,24,75,51,9
11/23/2017,Low Risk,0,13,13,5
8/29/2017,Low Risk,0,205,205,8
11/13/2017,Low Risk,28,80,52,9
10/13/2017,Low Risk,0,104,104,8
11/12/2017,Low Risk,702,712,10,10
11/11/2017,Low Risk,281,321,40,40
11/21/2017,Low Risk,37,66,29,8
9/6/2017,High Risk,201,532,331,12
11/10/2017,High Risk,100,209,109,104
10/25/2017,Low Risk,167,313,146,25
9/22/2017,Low Risk,236,311,75,75
12/3/2017,Low Risk,31,71,40,9
11/16/2017,Low Risk,124,188,64,61
7/14/2017,High Risk,121,447,326,284
11/21/2017,High Risk,78,154,76,74
10/30/2017,Low Risk,6,58,52,9
11/9/2017,Low Risk,0,88,88,9
11/14/2017,Low Risk,112,148,36,20
11/9/2017,Low Risk,35,76,41,12
11/16/2017,Low Risk,0,34,34,8
11/21/2017,Low Risk,62,80,18,18
11/30/2017,Low Risk,13,340,327,100
11/28/2017,Low Risk,120,141,21,24
11/27/2017,Low Risk,48,72,24,8
11/29/2017,Low Risk,26,69,43,11
11/27/2017,Low Risk,42,79,37,8
11/29/2017,Low Risk,104,140,36,12
3/3/2017,High Risk,163,531,368,94
12/5/2017,High Risk,104,443,339,336
11/22/2017,Low Risk,28,78,50,28
11/30/2017,Low Risk,279,287,8,8
12/7/2017,Low Risk,261,279,18,18
11/29/2017,Low Risk,213,250,37,35
11/18/2017,Low Risk,25,79,54,16
11/30/2017,Low Risk,117,160,43,12
12/4/2017,Low Risk,48,79,31,7
9/25/2017,Low Risk,0,119,119,9
9/4/2017,Low Risk,274,410,136,13
11/5/2017,Low Risk,0,82,82,8
11/3/2017,Low Risk,133,187,54,60
12/5/2017,Low Risk,0,29,29,8
12/11/2017,Low Risk,0,23,23,5
12/5/2017,Low Risk,89,154,65,28
12/5/2017,Low Risk,219,248,29,26
12/7/2017,Low Risk,265,291,26,26
12/8/2017,Low Risk,2,48,46,4
10/8/2017,Low Risk,253,276,23,23
12/6/2017,Low Risk,193,237,44,16
12/5/2017,Low Risk,206,225,19,19
12/16/2017,Low Risk,168,261,93,87
12/11/2017,Low Risk,35,80,45,5
12/6/2017,Low Risk,32,82,50,16
11/30/2017,Legal Case,538,579,41,973
12/15/2017,Legal Case,-695,19,714,102
11/21/2017,Low Risk,113,155,42,41
12/16/2017,Low Risk,154,221,67,4
12/8/2017,Low Risk,0,76,76,9
9/22/2017,High Risk,458,698,240,579
11/2/2017,Low Risk,476,551,75,27
11/9/2017,Low Risk,74,168,94,46
11/30/2017,Low Risk,17,70,53,21
11/16/2017,High Risk,215,307,92,88
12/24/2017,Low Risk,40,72,32,7
12/22/2017,Low Risk,357,591,234,14
11/4/2017,Low Risk,43,159,116,12
12/10/2017,Low Risk,122,159,37,10
12/10/2017,High Risk,195,546,351,194
12/7/2017,High Risk,-89,567,656,722
12/11/2017,Low Risk,139,143,4,4
12/8/2017,High Risk,190,284,94,86
1/6/2018,Low Risk,25,48,23,4
12/23/2017,Low Risk,140,164,24,13
12/7/2017,High Risk,327,461,134,40
12/11/2017,High Risk,108,278,170,151
12/19/2017,Low Risk,47,77,30,8
12/23/2017,Low Risk,6,57,51,27
1/4/2018,Low Risk,32,67,35,11
12/18/2017,Low Risk,168,177,9,9
12/20/2017,Low Risk,373,399,26,26
12/24/2017,Low Risk,0,82,82,7
1/3/2018,Low Risk,252,293,41,6
10/25/2017,High Risk,35,401,366,27
12/14/2017,Low Risk,231,245,14,14
1/10/2018,High Risk,15,128,113,91
1/17/2018,High Risk,208,280,72,68
11/12/2017,Low Risk,261,346,85,124
1/10/2018,Low Risk,39,68,29,18
1/18/2018,Low Risk,100,117,17,17
1/19/2018,Low Risk,-26,147,173,97
12/28/2017,Low Risk,159,166,7,7
1/6/2018,Low Risk,98,325,227,18
1/6/2018,Low Risk,42,69,27,4
1/6/2018,Low Risk,42,69,27,7
1/3/2018,Low Risk,160,168,8,8
12/30/2017,Low Risk,295,324,29,29
1/13/2018,Low Risk,15,62,47,9
1/12/2018,High Risk,86,174,88,84
11/28/2017,Low Risk,0,114,114,10
11/20/2017,Low Risk,57,184,127,20
12/15/2017,Low Risk,0,101,101,14
1/15/2018,High Risk,81,218,137,132
1/11/2018,Low Risk,205,216,11,11
1/12/2018,Low Risk,139,285,146,22
1/19/2018,Low Risk,170,207,37,33
1/16/2018,High Risk,85,141,56,126
1/6/2018,High Risk,150,478,328,570
1/14/2018,Low Risk,0,74,74,19
1/19/2018,High Risk,-43,230,273,176
1/16/2018,Low Risk,619,625,6,6
1/19/2018,Low Risk,0,69,69,15
1/12/2018,Low Risk,0,76,76,5
1/22/2018,Low Risk,35,71,36,16
1/24/2018,Low Risk,394,408,14,86
1/15/2018,Low Risk,237,297,60,13
1/20/2018,Low Risk,146,185,39,17
1/16/2018,Low Risk,41,85,44,8
1/24/2018,Low Risk,81,111,30,12
1/24/2018,High Risk,77,175,98,92
1/8/2018,Low Risk,69,77,8,8
1/31/2018,Low Risk,55,125,70,16
1/4/2018,High Risk,122,215,93,88
12/16/2017,Low Risk,233,320,87,8
1/19/2018,High Risk,341,368,27,34
1/9/2018,Low Risk,101,164,63,7
12/2/2017,Low Risk,0,110,110,16
1/30/2018,Low Risk,43,70,27,19
1/23/2018,Low Risk,32,80,48,26
1/25/2018,Legal Case,-71,707,778,684
1/22/2018,Low Risk,33,121,88,8
1/22/2018,Low Risk,263,289,26,26
1/20/2018,Low Risk,151,164,13,13
1/19/2018,High Risk,59,343,284,138
2/10/2018,Low Risk,119,139,20,20
12/29/2017,Low Risk,350,448,98,34
2/1/2018,High Risk,127,651,524,533
2/9/2018,Low Risk,57,66,9,6
2/10/2018,High Risk,131,151,20,109
2/20/2018,Low Risk,98,112,14,14
2/12/2018,Low Risk,107,120,13,13
12/11/2017,Low Risk,94,106,12,12
2/23/2018,Low Risk,6,17,11,9
1/27/2018,High Risk,79,172,93,42
2/19/2018,Low Risk,204,368,164,64
3/2/2018,High Risk,100,167,67,68
2/24/2018,Low Risk,124,130,6,6
3/2/2018,Low Risk,798,812,14,14
2/4/2018,High Risk,223,521,298,327
2/24/2018,Low Risk,53,112,59,59
1/1/2018,Low Risk,260,319,59,59
2/21/2018,Low Risk,115,125,10,9
3/5/2018,High Risk,84,499,415,408
2/23/2018,Low Risk,193,229,36,40
1/26/2018,High Risk,52,342,290,94
3/6/2018,Low Risk,113,127,14,14
3/14/2018,Low Risk,101,119,18,18
2/27/2018,Low Risk,260,282,22,22
2/28/2018,Low Risk,200,208,8,8
3/12/2018,Low Risk,43,59,16,8
3/6/2018,Low Risk,162,211,49,9
3/16/2018,Low Risk,20,59,39,4
3/13/2018,Low Risk,-7,34,41,18
1/27/2018,Low Risk,201,270,69,18
3/17/2018,Low Risk,29,62,33,24
2/19/2018,Low Risk,153,165,12,12
3/9/2018,Low Risk,127,173,46,16
2/25/2018,Low Risk,295,313,18,18
3/7/2018,Low Risk,47,69,22,14
1/10/2018,High Risk,601,854,253,308
3/15/2018,Low Risk,77,119,42,4
12/29/2017,Low Risk,0,143,143,21
1/28/2018,Low Risk,111,233,122,14
1/2/2018,Low Risk,208,233,25,25
2/15/2018,High Risk,295,398,103,505
3/16/2018,Low Risk,692,733,41,185
3/1/2018,Low Risk,107,139,32,32
3/19/2018,Low Risk,124,128,4,4
1/17/2018,Low Risk,47,180,133,9
1/6/2018,Low Risk,125,137,12,12
3/19/2018,Low Risk,193,205,12,12
4/4/2018,Low Risk,36,58,22,13
3/20/2018,Low Risk,11,62,51,10
3/14/2018,Low Risk,166,181,15,15
3/19/2018,Low Risk,71,122,51,14
3/23/2018,Low Risk,34,61,27,4
2/18/2018,Low Risk,39,111,72,68
3/28/2018,Low Risk,148,169,21,13
3/22/2018,Low Risk,3,63,60,17
3/20/2018,Low Risk,86,155,69,20
3/15/2018,Low Risk,0,33,33,13
1/10/2018,Low Risk,86,219,133,22
3/11/2018,Low Risk,79,138,59,22
3/22/2018,Low Risk,20,68,48,12
3/26/2018,Low Risk,22,66,44,8
3/26/2018,High Risk,152,325,173,169
3/16/2018,Legal Case,-36,118,154,902
3/22/2018,High Risk,82,224,142,137
2/19/2018,High Risk,595,653,58,131
4/1/2018,Low Risk,57,65,8,8
3/19/2018,Low Risk,110,161,51,17
3/26/2018,Low Risk,91,135,44,13
4/17/2018,Low Risk,125,129,4,4
2/6/2018,Low Risk,36,163,127,5
3/10/2018,Low Risk,39,135,96,4
3/2/2018,Low Risk,155,258,103,22
4/4/2018,Legal Case,-633,226,859,146
3/29/2018,Low Risk,288,356,68,17
3/23/2018,Low Risk,270,292,22,22
3/20/2018,Low Risk,91,149,58,4
4/20/2018,Low Risk,98,110,12,12
3/10/2018,Low Risk,143,173,30,30
4/9/2018,High Risk,99,247,148,93
4/2/2018,Low Risk,100,149,49,20
4/13/2018,Low Risk,24,59,35,10
4/15/2018,Low Risk,115,131,16,16
4/7/2018,Low Risk,14,58,44,15
3/21/2018,Low Risk,66,187,121,16
4/10/2018,Low Risk,162,227,65,15
4/6/2018,High Risk,76,391,315,305
4/13/2018,Low Risk,8,61,53,4
3/28/2018,Low Risk,14,68,54,8
3/6/2018,Low Risk,270,339,69,55
4/6/2018,Low Risk,135,145,10,10
3/5/2018,Low Risk,113,149,36,36
4/20/2018,Low Risk,101,115,14,14
4/9/2018,Low Risk,122,184,62,62
4/24/2018,Low Risk,-152,1,153,49
3/17/2018,Low Risk,85,138,53,8
4/19/2018,High Risk,45,145,100,95
4/18/2018,Low Risk,101,141,40,14
4/23/2018,Low Risk,-2,128,130,8
3/28/2018,Low Risk,171,195,24,24
4/18/2018,Low Risk,123,202,79,10
4/27/2018,Legal Case,-5,117,122,13
4/26/2018,Low Risk,110,146,36,17
3/22/2018,Legal Case,1020,1202,182,659
4/15/2018,Low Risk,104,115,11,11
4/20/2018,Low Risk,375,392,17,17
3/10/2018,Low Risk,69,150,81,14
4/20/2018,Low Risk,7,62,55,11
3/30/2018,High Risk,407,496,89,107
4/17/2018,Low Risk,106,119,13,13
4/28/2018,Low Risk,36,59,23,7
4/24/2018,High Risk,135,177,42,32
4/7/2018,Low Risk,167,214,47,14
4/30/2018,Low Risk,13,58,45,8
12/21/2017,Low Risk,15,183,168,15
5/4/2018,Low Risk,23,55,32,4
5/2/2018,Low Risk,127,161,34,4
4/16/2018,Low Risk,141,149,8,8
4/19/2018,Legal Case,104,462,358,820
4/30/2018,Low Risk,190,218,28,28
4/11/2018,Low Risk,101,118,17,17
4/26/2018,Low Risk,0,28,28,13
4/16/2018,High Risk,52,171,119,105
5/2/2018,High Risk,120,217,97,96
1/21/2018,Low Risk,0,144,144,10
4/26/2018,Low Risk,271,307,36,28
4/18/2018,Low Risk,0,98,98,9
5/10/2018,Low Risk,104,131,27,54
5/9/2018,Low Risk,43,64,21,12
5/7/2018,Low Risk,187,212,25,25
5/13/2018,Low Risk,100,130,30,4
3/9/2018,Low Risk,31,161,130,8
3/1/2018,Low Risk,0,138,138,8
5/16/2018,Low Risk,55,202,147,21
5/8/2018,Low Risk,77,133,56,5
5/16/2018,Low Risk,144,189,45,45
5/7/2018,High Risk,87,150,63,61
4/13/2018,Low Risk,96,192,96,10
5/16/2018,Low Risk,26,49,23,4
5/14/2018,High Risk,245,373,128,126
5/18/2018,Low Risk,124,145,21,7
5/11/2018,Low Risk,16,70,54,20
5/10/2018,Low Risk,123,145,22,22
5/16/2018,Low Risk,64,76,12,12
5/17/2018,High Risk,120,204,84,97
3/7/2018,Low Risk,0,141,141,22
4/4/2018,Low Risk,65,183,118,17
4/10/2018,Low Risk,72,191,119,24
4/25/2018,Low Risk,0,104,104,12
5/24/2018,Low Risk,12,55,43,27
5/9/2018,Low Risk,103,156,53,51
5/27/2018,Low Risk,1164,1174,10,9
5/22/2018,High Risk,104,140,36,32
5/16/2018,Low Risk,188,273,85,18
5/3/2018,Low Risk,171,186,15,15
5/1/2018,Low Risk,136,148,12,12
5/15/2018,Low Risk,178,202,24,24
5/3/2018,Low Risk,0,96,96,8
4/11/2018,Low Risk,78,148,70,42
5/23/2018,Low Risk,95,139,44,7
5/21/2018,Low Risk,33,58,25,4
4/12/2018,Low Risk,0,62,62,12
5/20/2018,Low Risk,0,82,82,13
5/25/2018,Low Risk,85,115,30,30
5/8/2018,Low Risk,0,57,57,4
5/4/2018,Low Risk,106,187,81,19
4/17/2018,Low Risk,59,156,97,16
4/23/2018,Low Risk,114,148,34,33
5/15/2018,High Risk,226,288,62,87
5/31/2018,Low Risk,86,111,25,16
5/18/2018,High Risk,162,244,82,141
5/23/2018,High Risk,48,152,104,96
5/6/2018,Low Risk,231,472,241,35
4/16/2018,Low Risk,50,116,66,28
6/1/2018,Legal Case,35,132,97,332
4/15/2018,Low Risk,67,135,68,4
4/23/2018,Low Risk,61,120,59,6
5/8/2018,High Risk,458,470,12,66
5/8/2018,High Risk,70,119,49,38
5/30/2018,Low Risk,0,76,76,26
5/15/2018,Low Risk,83,135,52,13
5/25/2018,High Risk,764,1141,377,394
4/25/2018,Legal Case,109,317,208,399
6/5/2018,Low Risk,139,169,30,14
5/31/2018,Low Risk,24,57,33,8
5/19/2018,Low Risk,16,61,45,12
6/1/2018,Legal Case,185,454,269,703
6/17/2018,Low Risk,49,72,23,10
5/21/2018,Low Risk,77,122,45,8
5/31/2018,Low Risk,61,103,42,9
5/30/2018,Low Risk,228,238,10,10
6/1/2018,High Risk,110,221,111,169
6/13/2018,High Risk,131,236,105,23
9/8/2017,High Risk,178,533,355,134
7/2/2017,Low Risk,313,347,34,34
6/7/2018,Low Risk,111,139,28,28
5/24/2018,Low Risk,51,118,67,11
6/11/2018,Low Risk,65,77,12,12
6/6/2018,Legal Case,-301,140,441,46
5/11/2018,Low Risk,134,144,10,10
6/7/2018,High Risk,183,246,63,60
6/6/2018,Low Risk,223,266,43,26
6/9/2018,Low Risk,60,72,12,12
6/2/2018,Low Risk,92,144,52,17
6/16/2018,Low Risk,0,68,68,8
6/6/2018,High Risk,119,225,106,87
6/11/2018,Low Risk,138,163,25,25
6/9/2018,Low Risk,186,227,41,15
5/10/2018,High Risk,-1,189,190,184
6/6/2018,Low Risk,134,182,48,19
5/27/2018,Low Risk,62,115,53,11
5/25/2018,Low Risk,0,131,131,11
5/26/2018,Low Risk,102,167,65,8
6/4/2018,Low Risk,299,311,12,12
6/5/2018,Low Risk,76,84,8,8
6/20/2018,Low Risk,97,162,65,16
6/7/2018,Low Risk,310,363,53,4
6/24/2018,High Risk,74,108,34,32
5/17/2018,Low Risk,322,342,20,20
6/7/2018,Low Risk,176,188,12,12
6/10/2018,High Risk,152,186,34,32
6/22/2018,Low Risk,161,173,12,12
6/20/2018,Low Risk,0,64,64,8
6/22/2018,Low Risk,76,152,76,15
7/7/2018,High Risk,114,425,311,301
6/6/2018,Low Risk,44,107,63,10
6/25/2018,High Risk,94,234,140,221
6/22/2018,Low Risk,200,248,48,11
6/27/2018,Low Risk,23,71,48,26
6/19/2018,Low Risk,137,160,23,23
7/8/2018,Low Risk,20,53,33,8
6/20/2018,Low Risk,230,239,9,9
6/20/2018,Low Risk,169,275,106,18
7/8/2018,Low Risk,135,157,22,22
6/28/2018,Low Risk,64,124,60,9
6/29/2018,Low Risk,19,61,42,8
6/22/2018,Low Risk,184,196,12,12
7/5/2018,Low Risk,93,148,55,10
6/1/2018,Low Risk,191,321,130,216
7/4/2018,Low Risk,0,70,70,8
7/23/2018,High Risk,136,219,83,83
7/24/2018,Low Risk,78,129,51,17
6/21/2018,Low Risk,91,127,36,15
5/7/2018,Low Risk,24,105,81,4
5/11/2018,Low Risk,25,105,80,5
6/2/2018,High Risk,100,214,114,100
7/19/2018,Low Risk,128,146,18,18
6/30/2018,Low Risk,118,166,48,20
6/26/2018,Low Risk,24,69,45,9
7/20/2018,Low Risk,48,69,21,4
7/17/2018,Low Risk,134,148,14,14
7/16/2018,Low Risk,79,121,42,42
2/15/2018,High Risk,369,580,211,110
6/30/2018,Low Risk,152,236,84,84
7/20/2018,Low Risk,52,66,14,8
8/1/2018,Low Risk,303,336,33,34
7/20/2018,High Risk,210,278,68,63
7/13/2018,Low Risk,44,147,103,16
6/27/2018,Low Risk,11,75,64,10
7/25/2018,Low Risk,129,155,26,6
7/2/2018,Low Risk,67,71,4,4
7/22/2018,Low Risk,544,548,4,4
7/31/2018,Low Risk,193,295,102,102
7/26/2018,Low Risk,211,230,19,19
8/1/2018,Legal Case,106,135,29,4
8/1/2018,Low Risk,42,71,29,4
1/1/2018,High Risk,-1,352,353,319
7/28/2018,High Risk,138,326,188,183
8/1/2018,Low Risk,27,56,29,21
7/25/2018,High Risk,14,177,163,100
7/10/2018,Low Risk,0,42,42,5
7/8/2018,Low Risk,107,179,72,22
8/3/2018,Low Risk,254,300,46,9
7/25/2018,Low Risk,191,208,17,17
6/29/2018,Low Risk,0,102,102,11
7/7/2018,Low Risk,269,341,72,72
7/2/2018,Low Risk,0,101,101,14
7/30/2018,Low Risk,89,120,31,10
6/4/2018,Low Risk,90,130,40,36
5/8/2018,Low Risk,91,143,52,51
8/7/2018,High Risk,200,363,163,129
8/10/2018,Low Risk,0,25,25,15
7/26/2018,Low Risk,0,63,63,8
7/4/2018,Low Risk,0,131,131,17
6/26/2018,High Risk,94,307,213,202
7/11/2018,Low Risk,9,58,49,8
8/13/2018,Low Risk,146,198,52,18
7/30/2018,Low Risk,112,142,30,30
8/1/2018,High Risk,250,280,30,161
8/1/2018,Low Risk,158,175,17,17
8/9/2018,Low Risk,46,127,81,15
8/17/2018,Low Risk,0,24,24,19
8/17/2018,Low Risk,87,125,38,4
8/23/2018,Low Risk,127,194,67,13
8/11/2018,Low Risk,13,51,38,10
6/21/2018,Low Risk,232,251,19,19
8/28/2018,Low Risk,0,9,9,8
8/15/2018,Low Risk,0,68,68,15
8/23/2018,Low Risk,163,182,19,19
8/24/2018,Legal Case,224,383,159,83
8/10/2018,Low Risk,104,124,20,20
8/16/2018,High Risk,-229,231,460,309
7/1/2018,Low Risk,102,129,27,27
8/27/2018,Low Risk,161,198,37,9
8/3/2018,Low Risk,14,66,52,22
8/21/2018,High Risk,57,203,146,141
6/25/2018,Low Risk,108,214,106,14
7/3/2018,Low Risk,339,400,61,48
8/12/2018,Low Risk,9,257,248,248
7/28/2018,Low Risk,85,172,87,10
7/23/2018,Low Risk,34,114,80,14
8/14/2018,Low Risk,787,828,41,76
9/7/2018,Low Risk,79,117,38,35
8/2/2018,Low Risk,168,196,28,28
9/8/2018,Low Risk,2,33,31,11
8/12/2018,Low Risk,89,150,61,7
9/18/2018,Low Risk,616,626,10,6
9/2/2018,Low Risk,106,142,36,34
9/17/2018,High Risk,222,358,136,121
8/11/2018,Low Risk,21,75,54,26
9/9/2018,Low Risk,181,253,72,9
9/8/2018,Low Risk,24,61,37,13
9/7/2018,Low Risk,16,47,31,16
9/7/2018,Low Risk,21,25,4,4
9/5/2018,Low Risk,10,28,18,18
8/22/2018,High Risk,71,149,78,430
9/6/2018,Low Risk,48,76,28,21
9/6/2018,Low Risk,185,202,17,17
9/9/2018,Low Risk,139,166,27,51
9/10/2018,Low Risk,50,79,29,8
9/11/2018,Low Risk,436,450,14,14
8/13/2018,Low Risk,795,802,7,7
8/23/2018,High Risk,104,280,176,143
8/21/2018,High Risk,66,143,77,74
9/11/2018,Low Risk,136,155,19,19
9/4/2018,Low Risk,367,393,26,26
8/25/2018,Low Risk,139,174,35,33
9/12/2018,Low Risk,0,97,97,8
9/17/2018,Low Risk,103,197,94,52
9/14/2018,Low Risk,42,67,25,11
9/4/2018,Low Risk,119,127,8,8
8/28/2018,Low Risk,45,100,55,17
9/21/2018,Low Risk,198,217,19,7
9/2/2018,Low Risk,438,444,6,6
9/20/2018,Legal Case,173,194,21,8
9/14/2018,Low Risk,99,124,25,25
9/14/2018,Low Risk,45,101,56,8
9/16/2018,Low Risk,620,626,6,6
8/27/2018,Low Risk,71,137,66,36
9/25/2018,Low Risk,140,167,27,27
8/24/2018,Low Risk,0,52,52,9
9/10/2018,Low Risk,174,184,10,10
9/27/2018,High Risk,-55,19,74,69
9/21/2018,Low Risk,0,89,89,25
10/4/2018,Low Risk,0,27,27,8
9/26/2018,Low Risk,111,124,13,43
9/13/2018,Low Risk,0,36,36,5
9/20/2018,Low Risk,0,89,89,12
9/17/2018,Low Risk,228,239,11,11
9/13/2018,Low Risk,225,274,49,8
9/17/2018,Low Risk,70,113,43,19
8/27/2018,Low Risk,8,72,64,17
9/24/2018,Legal Case,113,228,115,55
10/2/2018,High Risk,32,330,298,38
8/28/2018,Low Risk,65,149,84,20
7/30/2018,Low Risk,93,136,43,43
9/28/2018,Low Risk,27,173,146,17
9/25/2018,Low Risk,239,244,5,5
10/10/2018,Low Risk,-2,12,14,14
10/3/2018,High Risk,125,245,120,164
9/26/2018,High Risk,323,349,26,67
9/3/2018,High Risk,58,268,210,201
9/7/2018,Low Risk,119,180,61,61
10/1/2018,Low Risk,30,80,50,4
10/8/2018,Low Risk,0,17,17,9
10/8/2018,Low Risk,233,261,28,12
9/27/2018,Low Risk,24,64,40,7
9/16/2018,Low Risk,107,158,51,21
10/14/2018,Low Risk,118,158,40,43
8/19/2018,Low Risk,134,198,64,64
10/12/2018,Low Risk,713,719,6,6
10/13/2018,Low Risk,5,60,55,8
10/9/2018,Low Risk,179,196,17,17
10/13/2018,Low Risk,0,31,31,8
10/3/2018,Low Risk,128,196,68,22
10/13/2018,Low Risk,117,156,39,9
10/4/2018,Low Risk,3,32,29,29
10/9/2018,Low Risk,119,127,8,8
10/16/2018,Low Risk,186,210,24,4
10/10/2018,High Risk,158,280,122,182
10/7/2018,Low Risk,116,136,20,20
10/13/2018,Low Risk,87,153,66,66
10/5/2018,Low Risk,222,243,21,21
8/30/2018,Low Risk,313,447,134,17
10/16/2018,Low Risk,90,132,42,7
9/25/2018,Low Risk,90,153,63,4
10/18/2018,High Risk,158,236,78,90
9/1/2018,Low Risk,280,347,67,48
8/21/2018,Low Risk,112,120,8,8
8/20/2018,Low Risk,62,161,99,26
10/22/2018,Low Risk,287,310,23,12
10/20/2018,High Risk,76,194,118,114
10/25/2018,Low Risk,198,232,34,9
10/8/2018,Low Risk,254,326,72,19
10/11/2018,High Risk,-33,307,340,149
10/26/2018,Low Risk,145,157,12,12
9/28/2018,Low Risk,148,202,54,21
10/24/2018,Low Risk,137,558,421,11
10/30/2018,Low Risk,106,133,27,15
10/30/2018,Low Risk,194,204,10,10
11/8/2018,Low Risk,134,138,4,4
10/26/2018,Low Risk,221,230,9,9
10/26/2018,Low Risk,213,234,21,21
10/28/2018,Low Risk,226,233,7,7
11/1/2018,Low Risk,59,141,82,30
11/9/2018,Low Risk,0,84,84,6
11/6/2018,Low Risk,609,622,13,13
8/25/2018,Low Risk,44,179,135,10
3/8/2018,High Risk,1001,1001,0,26
9/15/2018,Low Risk,132,201,69,69
10/24/2018,Low Risk,34,76,42,10
11/10/2018,Low Risk,184,193,9,9
11/7/2018,High Risk,290,387,97,265
11/4/2018,Low Risk,243,254,11,11
9/10/2018,High Risk,183,311,128,123
11/15/2018,Low Risk,843,1075,232,15
11/13/2018,Low Risk,0,72,72,9
11/3/2018,Low Risk,131,142,11,11
11/20/2018,Low Risk,443,646,203,9
11/9/2018,Low Risk,0,25,25,6
11/16/2018,High Risk,64,216,152,81
10/26/2018,Low Risk,53,101,48,11
10/23/2018,High Risk,66,177,111,40
11/9/2018,Low Risk,16,75,59,15
11/16/2018,Low Risk,22,74,52,8
11/4/2018,Low Risk,73,134,61,8
10/4/2018,Low Risk,635,657,22,22
11/23/2018,Legal Case,420,594,174,336
11/18/2018,Low Risk,120,143,23,23
11/2/2018,High Risk,199,251,52,54
10/13/2018,Low Risk,77,167,90,4
11/20/2018,Low Risk,69,225,156,22
11/17/2018,High Risk,886,1070,184,308
12/9/2018,Low Risk,0,19,19,8
9/10/2018,High Risk,-18,479,497,380
11/21/2018,Low Risk,95,132,37,7
11/28/2018,Low Risk,27,84,57,13
11/29/2018,Low Risk,39,92,53,43
11/27/2018,Low Risk,128,176,48,59
11/17/2018,Low Risk,28,96,68,20
11/21/2018,Low Risk,62,147,85,10
11/25/2018,Low Risk,125,185,60,11
12/1/2018,High Risk,84,172,88,82
11/28/2018,High Risk,-22,182,204,63
11/17/2018,Low Risk,197,207,10,10
11/19/2018,Low Risk,183,196,13,13
11/13/2018,High Risk,-349,295,644,563
12/11/2018,Low Risk,194,211,17,8
12/14/2018,Low Risk,220,236,16,16
10/30/2018,Low Risk,104,176,72,72
11/29/2018,Low Risk,291,407,116,17
12/10/2018,Low Risk,309,331,22,22
12/12/2018,Low Risk,0,138,138,11
12/8/2018,High Risk,399,579,180,349
12/11/2018,Low Risk,156,160,4,4
12/14/2018,Low Risk,0,59,59,9
12/14/2018,Low Risk,181,185,4,4
12/24/2018,Low Risk,0,14,14,8
11/26/2018,High Risk,90,260,170,255
12/17/2018,Low Risk,373,399,26,26
12/7/2018,Low Risk,793,815,22,22
12/13/2018,High Risk,24,112,88,73
12/22/2018,Low Risk,243,282,39,13
12/10/2018,High Risk,125,177,52,69
12/7/2018,Low Risk,173,187,14,14
12/12/2018,High Risk,86,155,69,64
12/22/2018,Low Risk,21,55,34,10
12/20/2018,High Risk,-306,659,965,275
1/12/2019,Low Risk,143,229,86,24
12/14/2018,High Risk,90,272,182,200
12/28/2018,Low Risk,145,222,77,77
1/3/2019,Low Risk,0,83,83,12
12/18/2018,Low Risk,70,76,6,6
12/5/2018,Low Risk,146,154,8,8
12/15/2018,High Risk,219,305,86,108
1/3/2019,Low Risk,123,151,28,28
11/25/2018,Low Risk,284,344,60,58
12/9/2018,Low Risk,41,121,80,4
1/7/2019,Legal Case,-51,128,179,58
1/2/2019,Low Risk,127,145,18,18
1/9/2019,Low Risk,127,138,11,11
12/31/2018,Low Risk,47,92,45,41
1/2/2019,Low Risk,119,149,30,9
1/9/2019,Low Risk,105,127,22,6
1/9/2019,Legal Case,65,163,98,272
12/18/2018,High Risk,60,164,104,69
11/9/2018,Low Risk,0,125,125,9
1/14/2019,Low Risk,30,67,37,14
1/25/2019,Low Risk,39,63,24,14
1/26/2019,High Risk,26,228,202,150
1/10/2019,Low Risk,185,193,8,8
1/11/2019,Low Risk,136,166,30,30
12/17/2018,High Risk,51,150,99,73
1/7/2019,High Risk,350,546,196,154
1/12/2019,Low Risk,201,207,6,6
1/26/2019,Low Risk,28,65,37,18
1/9/2019,Low Risk,31,68,37,23
12/27/2018,Low Risk,25,36,11,11
12/31/2018,Low Risk,33,135,102,8
1/11/2019,Low Risk,58,189,131,11
1/3/2019,Legal Case,-330,0,330,300
1/12/2019,Low Risk,149,163,14,14
12/25/2018,Low Risk,146,300,154,10
1/13/2019,High Risk,80,135,55,48
1/17/2019,Low Risk,43,77,34,11
12/31/2018,Low Risk,254,766,512,14
1/14/2019,Low Risk,96,128,32,32
1/15/2019,Low Risk,97,141,44,19
1/22/2019,Low Risk,84,105,21,8
1/13/2019,High Risk,91,171,80,78
1/8/2019,Low Risk,131,162,31,31
1/23/2019,Low Risk,118,182,64,64
11/5/2018,Low Risk,379,634,255,7
1/24/2019,Low Risk,27,76,49,29
1/28/2019,Low Risk,52,80,28,7
1/17/2019,Low Risk,18,64,46,4
12/18/2018,Low Risk,319,329,10,10
2/4/2019,Legal Case,48,127,79,59
1/22/2019,Low Risk,258,314,56,28
1/31/2019,Low Risk,245,256,11,11
1/22/2019,Low Risk,178,195,17,17
2/2/2019,Low Risk,37,60,23,9
1/14/2019,High Risk,-12,201,213,104
1/14/2019,Low Risk,132,177,45,21
2/8/2019,High Risk,496,615,119,156
2/8/2019,Low Risk,178,194,16,16
2/1/2019,High Risk,243,278,35,91
2/16/2019,High Risk,72,615,543,526
2/1/2019,High Risk,413,584,171,189
2/13/2019,Low Risk,22,56,34,7
2/20/2019,Low Risk,35,57,22,4
2/13/2019,Low Risk,57,85,28,8
2/19/2019,High Risk,73,254,181,146
2/11/2019,Low Risk,212,338,126,7
2/8/2019,Low Risk,19,54,35,16
2/13/2019,Low Risk,168,268,100,14
2/12/2019,High Risk,26,85,59,59
2/19/2019,Low Risk,102,125,23,20
1/22/2019,High Risk,92,493,401,336
2/19/2019,Low Risk,181,478,297,293
1/3/2019,Low Risk,218,229,11,11
2/14/2019,High Risk,70,183,113,167
12/10/2018,High Risk,605,667,62,54
12/3/2018,Low Risk,475,714,239,17
1/8/2019,Low Risk,21,132,111,10
5/22/2017,Low Risk,0,654,654,17
2/19/2019,Legal Case,616,692,76,218
2/20/2019,Low Risk,83,140,57,9
2/21/2019,Low Risk,134,151,17,17
2/25/2019,High Risk,154,163,9,154
2/27/2019,Low Risk,102,112,10,10
2/19/2019,Low Risk,108,120,12,12
2/25/2019,Low Risk,242,260,18,18
2/16/2019,Low Risk,0,59,59,6
2/19/2019,Low Risk,85,129,44,46
2/24/2019,Low Risk,98,190,92,29
2/19/2019,Low Risk,98,133,35,8
2/4/2019,Low Risk,249,340,91,10
2/18/2019,Low Risk,127,185,58,12
2/28/2019,Low Risk,0,32,32,12
2/20/2019,High Risk,149,224,75,69
2/20/2019,Low Risk,0,29,29,8
2/28/2019,Low Risk,80,112,32,14
2/20/2019,Low Risk,32,65,33,8
2/28/2019,Low Risk,271,291,20,20
3/1/2019,High Risk,77,140,63,62
3/8/2019,Low Risk,0,17,17,8
3/2/2019,Low Risk,106,132,26,12
2/28/2019,Low Risk,101,190,89,9
2/10/2019,Low Risk,230,283,53,9
3/19/2019,High Risk,12,176,164,160
2/28/2019,Low Risk,70,112,42,41
2/21/2019,Low Risk,158,181,23,23
2/21/2017,Low Risk,681,758,77,77
3/2/2019,Low Risk,20,61,41,11
3/2/2019,High Risk,115,194,79,92
3/8/2019,Low Risk,79,87,8,8
3/5/2019,Low Risk,256,260,4,4
3/12/2019,Low Risk,90,149,59,22
2/20/2019,Low Risk,0,75,75,10
2/20/2019,Low Risk,0,86,86,14
2/24/2019,Low Risk,91,120,29,29
2/9/2019,Low Risk,161,226,65,61
3/12/2019,Low Risk,40,63,23,8
3/4/2019,Low Risk,161,177,16,16
2/23/2019,Low Risk,107,146,39,9
2/13/2019,Low Risk,588,657,69,69
3/17/2019,High Risk,608,624,16,237
3/16/2019,High Risk,123,209,86,83
2/28/2019,High Risk,431,481,50,52
2/25/2019,Low Risk,169,184,15,15
3/20/2019,Low Risk,0,23,23,9
3/21/2019,Low Risk,63,110,47,45
2/22/2019,Low Risk,180,263,83,5
3/26/2019,Low Risk,47,98,51,4
3/17/2019,Low Risk,89,191,102,19
3/18/2019,High Risk,611,595,-16,33
3/4/2019,Low Risk,446,631,185,8
3/26/2019,Low Risk,64,84,20,12
3/2/2019,Low Risk,646,674,28,28
4/4/2019,Low Risk,491,504,13,13
3/28/2019,High Risk,726,921,195,81
3/27/2019,Low Risk,154,170,16,16
4/2/2019,High Risk,124,470,346,126
3/29/2019,High Risk,210,468,258,238
3/29/2019,High Risk,379,790,411,174
3/24/2019,High Risk,125,255,130,113
4/14/2019,Low Risk,199,206,7,7
4/24/2019,Low Risk,52,82,30,7
4/17/2019,High Risk,86,121,35,34
4/9/2019,Low Risk,153,168,15,15
3/26/2019,High Risk,565,575,10,52
4/5/2019,Low Risk,65,110,45,12
4/1/2019,High Risk,222,569,347,208
2/11/2019,Low Risk,49,176,127,12
3/12/2019,Low Risk,183,281,98,10
4/1/2019,Low Risk,0,35,35,7
3/28/2019,Low Risk,35,75,40,11
4/4/2019,High Risk,94,196,102,99
4/23/2019,High Risk,256,414,158,152
4/24/2019,Low Risk,0,92,92,8
3/25/2019,High Risk,90,570,480,70
4/30/2019,High Risk,8,204,196,140
4/23/2019,Low Risk,42,66,24,12
3/19/2019,Low Risk,62,71,9,9
4/26/2019,High Risk,123,263,140,119
3/29/2019,Low Risk,18,95,77,6
4/27/2019,Low Risk,56,72,16,16
4/25/2019,Low Risk,0,21,21,9
4/11/2019,Low Risk,59,137,78,14
4/24/2019,Low Risk,0,98,98,10
4/29/2019,Low Risk,40,78,38,4
4/16/2019,Low Risk,205,218,13,13
4/23/2019,Low Risk,35,63,28,8
4/17/2019,Low Risk,28,62,34,11
4/26/2019,High Risk,58,82,24,4
4/27/2019,Low Risk,196,220,24,12
5/3/2019,High Risk,15,119,104,88
4/11/2019,Low Risk,365,419,54,44
4/18/2019,Low Risk,99,154,55,10
5/6/2019,Low Risk,29,51,22,11
5/3/2019,Low Risk,31,63,32,6
5/3/2019,Low Risk,8,61,53,29
5/3/2019,High Risk,365,412,47,54
5/10/2019,High Risk,541,672,131,44
5/16/2019,Low Risk,99,201,102,100
4/7/2019,Low Risk,33,134,101,24
3/22/2019,High Risk,202,566,364,169
4/20/2019,High Risk,217,425,208,203
4/25/2019,Legal Case,294,406,112,294
5/17/2019,Low Risk,78,109,31,12
5/10/2019,Low Risk,63,109,46,41
4/26/2019,Low Risk,53,123,70,6
2/15/2019,Low Risk,606,628,22,22
5/14/2019,Low Risk,101,122,21,4
5/9/2019,Low Risk,54,111,57,24
5/8/2019,Low Risk,395,415,20,20
5/8/2019,Low Risk,0,72,72,13
5/4/2019,Low Risk,36,83,47,16
3/29/2019,Low Risk,0,123,123,11
4/2/2019,High Risk,17,142,125,120
4/29/2019,High Risk,429,513,84,17
5/17/2019,Low Risk,135,139,4,4
5/16/2019,Legal Case,159,173,14,13
4/18/2019,Low Risk,0,109,109,14
5/1/2019,Low Risk,427,440,13,13
5/17/2019,Low Risk,398,409,11,11
5/8/2019,High Risk,145,210,65,538
5/27/2019,Low Risk,37,137,100,15
5/18/2019,Low Risk,145,152,7,49
5/22/2019,Low Risk,28,65,37,29
4/27/2019,Low Risk,74,125,51,11
4/23/2019,Low Risk,51,107,56,10
5/21/2019,Low Risk,104,149,45,4
5/22/2019,Low Risk,337,370,33,15
5/18/2019,Low Risk,52,138,86,4
4/11/2019,Low Risk,110,160,50,49
4/25/2019,Low Risk,55,61,6,6
5/22/2019,Low Risk,52,121,69,11
5/23/2019,High Risk,306,385,79,103
5/12/2019,Low Risk,102,115,13,13
6/4/2019,Low Risk,1,70,69,11
5/16/2019,Low Risk,67,165,98,25
6/4/2019,Low Risk,29,126,97,10
6/10/2019,High Risk,-36,365,401,178
6/3/2019,Low Risk,167,266,99,26
5/10/2019,Low Risk,240,304,64,64
5/30/2019,Low Risk,0,27,27,12
6/3/2019,Low Risk,339,360,21,21
6/4/2019,Low Risk,85,99,14,14
6/8/2019,Low Risk,505,517,12,15
6/15/2019,Low Risk,570,577,7,7
5/31/2019,Low Risk,209,223,14,14
4/6/2019,Low Risk,221,228,7,7
6/1/2019,Low Risk,86,123,37,16
6/19/2019,Low Risk,24,79,55,8
6/20/2019,Low Risk,34,56,22,9
5/6/2019,Low Risk,104,130,26,26
5/19/2019,Low Risk,19,58,39,9
6/3/2019,Low Risk,148,168,20,20
6/7/2019,Low Risk,0,66,66,5
5/27/2019,Low Risk,129,147,18,18
11/2/2018,High Risk,268,747,479,255
6/8/2019,Low Risk,329,359,30,30
6/4/2019,Low Risk,10,111,101,10
5/4/2019,Low Risk,125,220,95,9
6/14/2019,High Risk,89,209,120,116
6/17/2019,High Risk,17,283,266,181
6/24/2019,Low Risk,70,120,50,11
6/19/2019,Low Risk,94,155,61,6
6/21/2019,Low Risk,94,153,59,13
6/17/2019,High Risk,109,350,241,232
6/24/2019,Low Risk,8,50,42,9
6/17/2019,Low Risk,29,53,24,14
6/25/2019,Low Risk,105,115,10,10
6/2/2019,Low Risk,121,136,15,15
6/4/2019,Low Risk,91,127,36,8
6/15/2019,Low Risk,0,97,97,7
6/18/2019,Low Risk,136,160,24,6
6/18/2019,High Risk,61,160,99,118
7/9/2019,Low Risk,96,105,9,8
6/25/2019,Low Risk,0,17,17,13
6/23/2019,Low Risk,0,73,73,8
6/15/2019,Low Risk,118,128,10,10
6/20/2019,High Risk,45,126,81,79
6/17/2019,Low Risk,33,98,65,7
6/19/2019,High Risk,66,141,75,69
6/21/2019,Low Risk,0,68,68,8
6/25/2019,Low Risk,25,56,31,4
6/6/2019,Low Risk,361,369,8,8
6/22/2019,High Risk,51,109,58,58
6/24/2019,Low Risk,27,57,30,18
7/10/2019,Low Risk,121,128,7,7
7/2/2019,Low Risk,4,56,52,24
7/4/2019,Low Risk,109,131,22,19
7/4/2019,High Risk,395,406,11,123
7/2/2019,High Risk,20,380,360,343
3/29/2019,Low Risk,94,223,129,125
6/27/2019,Low Risk,322,334,12,12
7/17/2019,Low Risk,0,96,96,9
7/9/2019,Low Risk,201,281,80,58
7/5/2019,Low Risk,33,68,35,9
7/12/2019,Low Risk,102,154,52,29
7/14/2019,Low Risk,33,65,32,7
7/13/2019,High Risk,300,478,178,287
7/19/2019,Low Risk,347,355,8,8
7/19/2019,Low Risk,113,117,4,4
7/27/2019,Low Risk,0,10,10,8
7/18/2019,Low Risk,109,118,9,9
7/12/2019,Low Risk,326,334,8,8
7/18/2019,Low Risk,85,97,12,12
7/30/2019,High Risk,140,436,296,126
6/28/2019,High Risk,-455,196,651,438
7/25/2019,Low Risk,133,172,39,23
7/2/2019,Low Risk,53,126,73,10
7/20/2019,Low Risk,264,279,15,15
7/27/2019,Low Risk,159,172,13,9
7/15/2019,Low Risk,456,469,13,13
7/24/2019,Low Risk,0,97,97,19
7/29/2019,Low Risk,56,73,17,6
7/20/2019,Low Risk,524,541,17,17
7/19/2019,Low Risk,75,82,7,7
6/30/2019,Legal Case,24,249,225,180
7/11/2019,Low Risk,503,523,20,20
7/25/2019,Low Risk,65,69,4,4
7/19/2019,Low Risk,405,453,48,33
8/10/2019,Low Risk,336,374,38,11
8/10/2019,Low Risk,55,81,26,8
7/20/2019,Low Risk,264,271,7,7
7/10/2019,Low Risk,425,482,57,18
7/31/2019,Low Risk,301,322,21,21
7/8/2019,Low Risk,149,184,35,33
6/21/2019,Low Risk,0,61,61,8
7/31/2019,Low Risk,26,77,51,6
8/3/2019,Low Risk,0,88,88,16
7/19/2019,Legal Case,142,244,102,83
7/15/2019,High Risk,210,305,95,90
7/19/2019,Low Risk,340,403,63,4
7/24/2019,Low Risk,0,61,61,7
7/16/2019,High Risk,212,310,98,94
8/2/2019,Low Risk,10,80,70,28
7/29/2019,Low Risk,115,143,28,5
7/5/2019,Low Risk,56,140,84,7
8/7/2019,Low Risk,380,464,84,28
7/22/2019,High Risk,143,235,92,89
6/28/2019,Low Risk,59,76,17,17
8/9/2019,Low Risk,264,313,49,7
8/13/2019,Low Risk,94,113,19,19
7/25/2019,High Risk,86,328,242,229
8/10/2019,Low Risk,257,298,41,37
7/26/2019,Low Risk,137,839,702,702
8/13/2019,High Risk,205,387,182,172
8/13/2019,Low Risk,603,615,12,12
8/8/2019,High Risk,484,580,96,216
7/17/2019,Low Risk,292,308,16,16
8/10/2019,Low Risk,27,53,26,14
7/9/2019,High Risk,476,484,8,104
8/12/2019,Low Risk,10,74,64,12
5/16/2019,Low Risk,35,217,182,23
5/15/2019,High Risk,0,222,222,12
6/14/2019,Low Risk,9,174,165,12
7/4/2019,Low Risk,598,609,11,11
7/30/2019,Low Risk,294,307,13,13
8/4/2019,Low Risk,244,302,58,56
8/23/2019,Low Risk,292,299,7,7
6/18/2019,Low Risk,605,615,10,10
7/14/2019,Low Risk,0,166,166,11
8/7/2019,Low Risk,181,271,90,13
9/5/2019,Low Risk,46,74,28,8
8/19/2019,Low Risk,99,108,9,9
8/29/2019,Low Risk,35,104,69,14
8/21/2019,Low Risk,26,56,30,6
8/23/2019,Low Risk,405,429,24,6
8/1/2019,Low Risk,233,308,75,17
8/6/2019,Low Risk,34,106,72,26
8/3/2019,Low Risk,41,115,74,16
7/29/2019,High Risk,179,302,123,119
7/22/2019,Low Risk,448,507,59,36
8/16/2019,High Risk,458,735,277,48
8/14/2019,High Risk,315,721,406,44
8/26/2019,Legal Case,-19,402,421,836
9/3/2019,High Risk,334,482,148,140
9/3/2019,Low Risk,29,70,41,9
9/13/2019,Low Risk,29,74,45,7
9/4/2019,Low Risk,0,20,20,7
9/3/2019,Low Risk,222,234,12,12
8/1/2019,Low Risk,212,293,81,26
8/29/2019,High Risk,167,293,126,120
8/15/2019,Low Risk,1,62,61,16
7/29/2019,High Risk,253,382,129,134
7/26/2019,Low Risk,119,180,61,51
8/24/2019,Low Risk,71,88,17,17
8/28/2019,Low Risk,321,371,50,8
9/21/2019,Low Risk,0,19,19,8
9/10/2019,Low Risk,168,293,125,13
9/2/2019,Low Risk,34,98,64,8
9/15/2019,Low Risk,28,79,51,8
9/2/2019,Low Risk,20,80,60,9
8/27/2019,High Risk,86,288,202,179
9/25/2019,High Risk,70,294,224,214
9/25/2019,Low Risk,23,56,33,19
9/12/2019,Low Risk,113,117,4,4
9/14/2019,High Risk,224,397,173,148
9/3/2019,Low Risk,293,309,16,16
9/20/2019,Low Risk,228,305,77,19
9/6/2019,Low Risk,34,95,61,21
8/17/2019,Low Risk,320,396,76,14
9/13/2019,Low Risk,297,318,21,21
8/29/2019,Low Risk,32,77,45,45
9/17/2019,Low Risk,375,412,37,15
9/3/2019,Low Risk,238,280,42,8
9/19/2019,Low Risk,28,54,26,12
9/6/2019,Low Risk,100,133,33,8
9/17/2019,Low Risk,0,119,119,10
9/21/2019,Low Risk,203,244,41,7
9/29/2019,Low Risk,177,192,15,9
9/18/2019,Low Risk,152,162,10,10
8/10/2019,Low Risk,95,108,13,13
9/17/2019,High Risk,486,709,223,506
9/20/2019,Low Risk,293,322,29,29
10/2/2019,Low Risk,431,442,11,11
9/22/2019,Low Risk,441,452,11,11
9/4/2019,Low Risk,210,261,51,46
9/13/2019,Low Risk,0,75,75,8
9/24/2019,Low Risk,168,274,106,10
9/19/2019,Low Risk,22,48,26,26
8/17/2019,Low Risk,-11,103,114,19
9/26/2019,Low Risk,218,271,53,50
9/22/2019,High Risk,151,256,105,100
8/22/2019,High Risk,269,455,186,176
10/2/2019,Low Risk,30,50,20,4
8/27/2019,Low Risk,224,288,64,8
9/13/2019,Low Risk,472,493,21,21
8/28/2019,Low Risk,73,112,39,36
9/17/2019,Low Risk,192,251,59,4
8/1/2019,High Risk,-19,378,397,394
10/9/2019,High Risk,357,455,98,96
9/10/2019,Low Risk,326,342,16,16
7/26/2019,Low Risk,300,418,118,30
9/27/2019,Low Risk,24,52,28,8
10/9/2019,High Risk,204,420,216,168
10/4/2019,Low Risk,320,334,14,14
9/26/2019,Low Risk,41,105,64,4
9/27/2019,Low Risk,306,326,20,20
10/18/2019,Low Risk,27,46,19,4
10/10/2019,Low Risk,122,137,15,15
10/12/2019,High Risk,227,387,160,230
10/15/2019,High Risk,182,274,92,90
10/11/2019,Low Risk,95,193,98,17
10/10/2019,Low Risk,0,99,99,9
10/20/2019,Low Risk,426,450,24,24
10/8/2019,High Risk,-27,457,484,88
9/23/2019,Low Risk,23,67,44,28
9/23/2019,Low Risk,285,297,12,12
10/2/2019,Low Risk,276,299,23,23
10/13/2019,Low Risk,138,225,87,13
10/8/2019,Low Risk,301,311,10,10
10/11/2019,Low Risk,259,308,49,5
10/17/2019,Low Risk,148,153,5,5
10/16/2019,Low Risk,44,141,97,6
10/14/2019,Low Risk,254,280,26,26
10/23/2019,High Risk,654,657,3,27
10/23/2019,High Risk,63,244,181,73
10/24/2019,High Risk,423,438,15,123
10/18/2019,Low Risk,414,425,11,11
10/31/2019,Low Risk,201,210,9,9
9/28/2019,Low Risk,8,83,75,26
10/24/2019,Low Risk,0,110,110,11
10/25/2019,High Risk,-686,228,914,97
10/30/2019,Low Risk,16,112,96,65
10/26/2019,Low Risk,0,24,24,5
10/27/2019,Low Risk,255,269,14,14
10/22/2019,High Risk,224,380,156,95
11/7/2019,Low Risk,327,347,20,20
10/27/2019,Low Risk,282,292,10,10
10/30/2019,Low Risk,239,251,12,12
10/30/2019,Low Risk,292,308,16,16
11/8/2019,High Risk,227,250,23,34
10/19/2019,Low Risk,262,269,7,7
11/9/2019,Low Risk,53,73,20,11
11/9/2019,Low Risk,317,390,73,10
11/11/2019,Low Risk,230,316,86,7
10/24/2019,Low Risk,253,264,11,11
11/8/2019,Low Risk,233,249,16,16
10/27/2019,Low Risk,64,143,79,6
10/29/2019,Low Risk,148,225,77,16
10/29/2019,Low Risk,362,407,45,10
11/18/2019,Low Risk,0,14,14,8
11/15/2019,Low Risk,308,318,10,10
11/21/2019,Low Risk,0,14,14,9
9/20/2019,High Risk,345,621,276,393
11/16/2019,Low Risk,0,121,121,4
8/26/2019,High Risk,203,408,205,42
11/13/2019,Low Risk,254,299,45,38
11/15/2019,Low Risk,153,238,85,85
10/12/2019,Low Risk,217,317,100,13
11/16/2019,Low Risk,257,269,12,12
10/8/2019,Low Risk,257,329,72,13
11/10/2019,Low Risk,282,304,22,45
11/11/2019,Low Risk,146,206,60,19
6/7/2019,High Risk,285,389,104,101
8/15/2019,Low Risk,249,372,123,12
11/26/2019,Low Risk,175,190,15,15
10/29/2019,Low Risk,279,421,142,10
10/12/2019,Low Risk,56,65,9,9
10/19/2019,High Risk,438,536,98,92
9/22/2019,Low Risk,459,558,99,50
11/19/2019,High Risk,385,434,49,49
10/24/2019,Low Risk,183,306,123,26
12/6/2019,Low Risk,28,103,75,7
11/29/2019,Low Risk,101,112,11,11
11/21/2019,Low Risk,259,285,26,26
11/26/2019,High Risk,114,408,294,107
12/9/2019,Low Risk,20,64,44,29
12/6/2019,Low Risk,341,353,12,12
12/3/2019,Low Risk,224,265,41,6
12/9/2019,Low Risk,23,59,36,13
11/29/2019,Low Risk,10,49,39,15
10/8/2019,High Risk,324,428,104,39
11/16/2019,Low Risk,292,299,7,7
12/5/2019,Low Risk,118,193,75,14
12/3/2019,Low Risk,90,167,77,8
12/15/2019,Low Risk,282,305,23,17
12/12/2019,Low Risk,253,307,54,48
12/14/2019,Low Risk,141,272,131,25
12/13/2019,Low Risk,229,299,70,64
12/18/2019,Low Risk,7,132,125,4
12/13/2019,Low Risk,131,229,98,7
12/11/2019,Low Risk,318,329,11,11
12/16/2019,Low Risk,28,91,63,8
12/20/2019,Low Risk,233,248,15,15
11/29/2019,Low Risk,163,264,101,96
1/4/2020,Low Risk,0,13,13,11
12/17/2019,Low Risk,469,491,22,14
11/5/2019,Low Risk,14,91,77,17
11/12/2019,Low Risk,96,108,12,12
9/11/2019,Low Risk,348,394,46,43
10/13/2019,Low Risk,22,117,95,11
12/16/2019,Low Risk,16,46,30,4
12/27/2019,High Risk,-30,439,469,258
12/7/2019,Low Risk,315,325,10,10
12/30/2019,High Risk,410,583,173,173
12/13/2019,High Risk,313,689,376,439
12/28/2019,High Risk,219,331,112,107
12/9/2019,Low Risk,224,294,70,49
12/31/2019,Low Risk,351,400,49,20
12/13/2019,Low Risk,0,61,61,26
1/12/2020,Low Risk,220,284,64,60
12/30/2019,High Risk,299,401,102,96
12/31/2019,Low Risk,102,126,24,24
9/23/2019,Low Risk,312,367,55,55
10/5/2019,Low Risk,26,199,173,14
10/6/2019,Low Risk,0,176,176,10
10/16/2019,Low Risk,0,166,166,9
10/16/2019,Low Risk,236,404,168,24
12/30/2019,Low Risk,14,46,32,10
12/19/2019,High Risk,231,308,77,70
12/12/2019,High Risk,67,407,340,165
1/7/2020,Low Risk,302,330,28,36
1/7/2020,Low Risk,256,335,79,11
12/31/2019,Low Risk,0,35,35,7
1/3/2020,Low Risk,287,319,32,6
12/12/2019,Low Risk,248,350,102,11
12/29/2019,Low Risk,31,109,78,12
11/25/2019,Low Risk,149,263,114,4
12/28/2019,Low Risk,31,110,79,6
12/16/2019,Low Risk,232,298,66,10
1/10/2020,Legal Case,732,773,41,26
1/8/2020,Low Risk,195,273,78,26
1/3/2020,Low Risk,175,187,12,12
1/10/2020,Low Risk,287,306,19,19
1/21/2020,High Risk,372,463,91,167
1/13/2020,Low Risk,125,176,51,9
1/7/2020,Low Risk,173,295,122,8
1/14/2020,Low Risk,220,318,98,11
12/12/2019,Low Risk,364,426,62,9
11/21/2019,High Risk,343,494,151,120
1/10/2020,Low Risk,147,187,40,39
1/7/2020,Low Risk,302,314,12,12
1/13/2020,Low Risk,86,149,63,4
1/15/2020,Low Risk,0,99,99,10
1/11/2020,Low Risk,0,37,37,10
1/4/2020,Low Risk,57,75,18,18
1/26/2020,Legal Case,190,317,127,119
2/6/2020,Low Risk,0,42,42,25
1/9/2020,High Risk,281,385,104,292
2/4/2020,Low Risk,292,309,17,17
2/5/2020,High Risk,231,441,210,212
1/22/2020,Low Risk,348,357,9,9
2/25/2020,Low Risk,2,64,62,6
10/24/2019,Low Risk,0,167,167,11
11/18/2019,Low Risk,29,184,155,11
11/21/2019,Low Risk,315,463,148,23
11/20/2019,Low Risk,429,467,38,38
2/9/2020,High Risk,-34,297,331,240
2/5/2020,Low Risk,268,315,47,47
2/14/2020,Low Risk,0,21,21,5
2/10/2020,Low Risk,276,298,22,22
2/25/2020,Low Risk,83,97,14,10
2/12/2020,Low Risk,69,90,21,21
2/6/2020,Legal Case,414,518,104,616
2/17/2020,Low Risk,232,324,92,29
12/9/2019,High Risk,267,403,136,97
2/6/2020,Low Risk,288,335,47,27
2/28/2020,Low Risk,293,376,83,17
2/22/2020,High Risk,-33,271,304,256
2/26/2020,Low Risk,230,287,57,24
2/24/2020,High Risk,390,396,6,5
2/27/2020,Low Risk,201,209,8,8
2/13/2020,Low Risk,179,193,14,14
2/19/2020,High Risk,163,267,104,102
2/21/2020,Low Risk,181,224,43,43
3/6/2020,Low Risk,0,81,81,15
2/24/2020,Legal Case,-150,201,351,492
2/19/2020,Low Risk,211,281,70,4
2/19/2020,Low Risk,226,240,14,14
1/9/2020,High Risk,338,552,214,204
3/18/2020,Low Risk,8,28,20,16
3/18/2020,Low Risk,0,69,69,8
2/28/2020,Low Risk,192,236,44,44
3/20/2020,Low Risk,0,15,15,12
3/20/2020,Low Risk,0,19,19,8
3/20/2020,Low Risk,0,30,30,4
3/22/2020,Low Risk,52,106,54,12
1/17/2020,Low Risk,0,433,433,24
3/6/2020,Low Risk,0,102,102,12
3/23/2020,High Risk,324,423,99,96
3/23/2020,High Risk,295,317,22,121
3/16/2020,Low Risk,0,43,43,12
3/11/2020,Low Risk,0,69,69,6
11/29/2019,Low Risk,208,234,26,26
3/21/2020,High Risk,107,305,198,193
3/19/2020,Low Risk,203,212,9,9
3/16/2020,Low Risk,258,295,37,8
3/24/2020,High Risk,77,262,185,180
3/16/2020,Low Risk,54,114,60,30
3/24/2020,High Risk,14,330,316,197
3/27/2020,High Risk,200,367,167,140
3/19/2020,Low Risk,208,222,14,14
3/26/2020,Low Risk,35,81,46,6
3/28/2020,Low Risk,59,139,80,29
3/25/2020,High Risk,223,343,120,23
4/5/2020,Low Risk,141,318,177,201
12/23/2019,Low Risk,225,400,175,27
4/3/2020,Low Risk,0,24,24,23
4/6/2020,Low Risk,230,275,45,8
3/23/2020,High Risk,404,493,89,80
3/24/2020,Low Risk,273,296,23,23
4/4/2020,High Risk,-40,292,332,176
4/8/2020,Low Risk,129,139,10,10
4/9/2020,Low Risk,60,71,11,11
4/10/2020,Low Risk,0,18,18,4
4/14/2020,High Risk,-15,756,771,584
4/9/2020,Low Risk,241,273,32,15
4/21/2020,High Risk,57,72,15,37
4/20/2020,Low Risk,0,16,16,11
4/17/2020,Low Risk,415,446,31,31
4/10/2020,Low Risk,246,276,30,30
4/19/2020,Low Risk,205,229,24,24
4/28/2020,Low Risk,380,400,20,4
4/19/2020,Low Risk,256,332,76,76
4/19/2020,Low Risk,0,26,26,4
4/14/2020,Low Risk,300,308,8,8
4/20/2020,Low Risk,45,88,43,14
4/26/2020,Low Risk,0,30,30,6
4/25/2020,Low Risk,0,31,31,5
5/2/2020,Low Risk,0,19,19,4
3/30/2020,Low Risk,0,50,50,22
3/31/2020,High Risk,162,245,83,196
4/17/2020,Low Risk,21,68,47,4
5/5/2020,High Risk,259,311,52,261
4/28/2020,Low Risk,0,36,36,14
4/21/2020,Low Risk,315,360,45,23
4/21/2020,Low Risk,274,317,43,10
2/27/2020,Low Risk,228,237,9,9
5/1/2020,Low Risk,0,26,26,4
5/10/2020,High Risk,152,283,131,129
4/29/2020,Low Risk,0,82,82,8
4/16/2020,High Risk,424,426,2,236
5/13/2020,Low Risk,0,77,77,16
5/2/2020,Low Risk,0,25,25,5
4/21/2020,Low Risk,0,36,36,9
5/13/2020,Low Risk,0,19,19,15
5/6/2020,Low Risk,60,78,18,18
5/13/2020,Low Risk,246,267,21,4
5/13/2020,High Risk,308,310,2,59
5/4/2020,Low Risk,319,382,63,4
4/25/2020,Low Risk,360,404,44,22
5/15/2020,Low Risk,0,14,14,8
4/30/2020,Low Risk,0,34,34,26
4/17/2020,Low Risk,317,369,52,15
5/21/2020,Low Risk,0,15,15,4
5/16/2020,Low Risk,70,355,285,20
4/27/2020,High Risk,105,234,129,96
5/18/2020,High Risk,250,283,33,37
5/17/2020,High Risk,252,521,269,504
5/18/2020,High Risk,174,598,424,330
5/27/2020,High Risk,151,467,316,42
5/12/2020,Low Risk,359,365,6,6
4/22/2020,High Risk,208,224,16,55
5/19/2020,Low Risk,390,414,24,24
6/6/2020,Low Risk,0,111,111,15
5/6/2020,High Risk,402,498,96,94
5/27/2020,Low Risk,93,99,6,6
5/14/2020,Low Risk,334,410,76,27
4/29/2020,Low Risk,360,443,83,16
5/20/2020,Low Risk,61,187,126,10
5/27/2020,Low Risk,57,79,22,5
5/27/2020,Low Risk,110,118,8,8
5/25/2020,Low Risk,621,630,9,9
6/4/2020,Low Risk,44,82,38,8
5/21/2020,Low Risk,223,272,49,17
5/28/2020,High Risk,125,258,133,100
6/5/2020,Low Risk,17,48,31,16
6/4/2020,Low Risk,0,15,15,4
5/30/2020,Low Risk,33,271,238,27
6/14/2020,High Risk,225,282,57,41
6/12/2020,Low Risk,132,213,81,45
6/15/2020,Low Risk,100,156,56,38
5/19/2020,High Risk,-102,66,168,389
5/31/2020,Low Risk,360,382,22,12
5/21/2020,High Risk,206,287,81,76
6/12/2020,Low Risk,0,11,11,10
6/8/2020,High Risk,118,238,120,168
6/1/2020,Low Risk,344,367,23,13
6/2/2020,Low Risk,43,83,40,6
6/9/2020,Low Risk,159,170,11,11
5/4/2020,Low Risk,0,197,197,13
5/26/2020,High Risk,419,468,49,41
6/20/2020,Low Risk,0,26,26,18
6/9/2020,High Risk,149,274,125,122
3/16/2020,High Risk,369,562,193,353
6/1/2020,Low Risk,86,136,50,19
5/13/2020,Low Risk,704,742,38,38
6/12/2020,Low Risk,176,180,4,4
6/10/2020,Low Risk,25,187,162,10
6/28/2020,Low Risk,0,64,64,13
6/10/2020,Low Risk,0,75,75,9
6/21/2020,Low Risk,213,255,42,42
6/17/2020,High Risk,89,173,84,73
6/11/2020,High Risk,378,452,74,93
6/12/2020,Low Risk,189,250,61,42
6/10/2020,Low Risk,43,84,41,10
6/14/2020,Low Risk,0,80,80,14
6/11/2020,Low Risk,273,307,34,17
6/10/2020,Low Risk,342,434,92,25
6/6/2020,Low Risk,181,191,10,10
6/7/2020,Low Risk,124,246,122,12
6/18/2020,High Risk,455,538,83,640
6/20/2020,Low Risk,40,80,40,6
6/22/2020,Low Risk,80,116,36,27
6/24/2020,Low Risk,0,28,28,6
6/15/2020,High Risk,208,260,52,67
7/2/2020,High Risk,240,284,44,42
6/30/2020,Low Risk,0,15,15,6
6/30/2020,Low Risk,43,58,15,26
6/23/2020,Low Risk,529,547,18,18
6/16/2020,Legal Case,413,477,64,27
6/25/2020,High Risk,128,214,86,228
6/22/2020,High Risk,-1,240,241,124
6/16/2020,Low Risk,73,104,31,19
6/9/2020,Low Risk,147,197,50,50
6/30/2020,Low Risk,300,308,8,8
7/2/2020,Low Risk,218,264,46,12
6/18/2020,High Risk,128,266,138,249
7/4/2020,Low Risk,153,179,26,4
6/30/2020,Low Risk,219,246,27,20
6/21/2020,High Risk,134,199,65,40
7/7/2020,Low Risk,138,163,25,25
7/6/2020,Low Risk,92,142,50,21
6/25/2020,Low Risk,175,209,34,28
7/1/2020,High Risk,231,317,86,82
6/10/2020,Low Risk,98,176,78,12
5/31/2020,Low Risk,303,368,65,22
6/17/2020,Low Risk,562,610,48,6
7/2/2020,Legal Case,168,181,13,12
7/7/2020,High Risk,205,325,120,211
7/6/2020,Low Risk,0,71,71,28
6/23/2020,High Risk,78,177,99,97
6/9/2020,Low Risk,418,469,51,16
9/11/2019,Low Risk,779,807,28,28
7/8/2020,Low Risk,0,20,20,4
7/2/2020,High Risk,163,280,117,114
7/2/2020,Low Risk,453,468,15,15
7/7/2020,Low Risk,39,77,38,12
7/15/2020,Low Risk,0,22,22,15
7/6/2020,Low Risk,39,78,39,30
7/20/2020,High Risk,128,212,84,80
7/3/2020,High Risk,191,252,61,56
6/23/2020,High Risk,139,204,65,64
7/18/2020,High Risk,389,633,244,30
7/6/2020,Low Risk,181,227,46,7
7/13/2020,Low Risk,201,213,12,12
7/13/2020,Low Risk,141,149,8,8
7/14/2020,High Risk,154,253,99,70
7/19/2020,High Risk,176,217,41,41
7/10/2020,Low Risk,135,187,52,22
7/28/2020,High Risk,398,624,226,25
7/24/2020,Low Risk,202,228,26,12
6/24/2020,Low Risk,293,439,146,11
7/17/2020,Low Risk,0,90,90,8
7/16/2020,Low Risk,290,371,81,81
7/19/2020,Low Risk,2,40,38,22
7/28/2020,High Risk,169,232,63,63
6/11/2020,Low Risk,62,152,90,4
7/22/2020,High Risk,70,141,71,71
7/28/2020,Low Risk,318,360,42,20
7/31/2020,Low Risk,174,192,18,18
7/13/2020,Low Risk,15,66,51,6
7/29/2020,Low Risk,0,29,29,9
6/24/2020,High Risk,114,197,83,62
7/13/2020,High Risk,117,183,66,66
7/7/2020,Low Risk,146,198,52,7
7/4/2020,Low Risk,25,79,54,8
7/13/2020,Low Risk,348,420,72,8
7/1/2020,Low Risk,131,169,38,38
7/30/2020,Low Risk,149,167,18,18
7/24/2020,High Risk,167,228,61,118
8/3/2020,Low Risk,159,189,30,30
8/4/2020,Low Risk,160,168,8,8
7/26/2020,Low Risk,201,213,12,12
8/4/2020,High Risk,301,352,51,64
6/29/2020,Low Risk,336,375,39,39
8/8/2020,Low Risk,20,52,32,32
8/12/2020,Legal Case,-93,278,371,62
8/12/2020,Low Risk,0,29,29,17
7/15/2020,High Risk,110,336,226,212
8/31/2020,Low Risk,0,92,92,8
8/8/2020,Low Risk,172,184,12,12
7/28/2020,High Risk,318,451,133,48
6/11/2020,Low Risk,181,305,124,4
8/19/2020,High Risk,98,296,198,33
7/8/2020,Low Risk,125,183,58,58
7/3/2020,High Risk,142,308,166,160
7/9/2020,Low Risk,136,232,96,14
7/27/2020,High Risk,160,261,101,74
8/12/2020,Low Risk,320,357,37,13
8/25/2020,Low Risk,0,15,15,15
5/25/2020,Low Risk,179,183,4,4
8/15/2020,Low Risk,16,67,51,28
7/29/2020,Low Risk,11,54,43,8
8/11/2020,High Risk,18,196,178,173
8/24/2020,Low Risk,139,177,38,38
8/28/2020,High Risk,292,342,50,48
8/14/2020,Low Risk,0,38,38,11
8/8/2020,Low Risk,91,152,61,24
7/25/2020,Low Risk,503,565,62,56
6/12/2020,Low Risk,177,280,103,59
9/12/2020,Low Risk,0,80,80,5
9/6/2020,High Risk,117,227,110,60
8/25/2020,Low Risk,659,689,30,30
9/5/2020,Low Risk,45,82,37,10
8/16/2020,Low Risk,20,73,53,30
9/5/2020,Low Risk,116,152,36,37
9/5/2020,Low Risk,0,32,32,16
9/2/2020,Low Risk,115,135,20,20
8/28/2020,Low Risk,84,137,53,10
9/8/2020,Low Risk,71,78,7,7
8/28/2020,Low Risk,141,145,4,4
9/11/2020,Low Risk,39,88,49,16
9/7/2020,High Risk,-108,123,231,147
9/12/2020,Low Risk,0,24,24,5
9/24/2020,High Risk,204,274,70,71
9/13/2020,Low Risk,58,94,36,15
7/31/2020,Low Risk,0,97,97,15
9/10/2020,Low Risk,54,63,9,9
8/18/2020,High Risk,534,661,127,409
6/18/2020,High Risk,99,274,175,170
7/4/2020,Low Risk,79,132,53,40
9/11/2020,Low Risk,91,174,83,18
8/27/2020,Low Risk,187,194,7,7
9/15/2020,Low Risk,230,323,93,6
9/30/2020,Low Risk,0,52,52,19
9/22/2020,Low Risk,0,72,72,26
9/16/2020,Low Risk,204,260,56,30
10/5/2020,Low Risk,96,113,17,9
9/23/2020,Low Risk,0,28,28,5
9/21/2020,High Risk,89,199,110,104
9/23/2020,High Risk,229,330,101,100
9/19/2020,High Risk,114,219,105,98
9/23/2020,Low Risk,337,376,39,39
9/26/2020,High Risk,-197,242,439,164
10/7/2020,Low Risk,211,246,35,29
10/3/2020,Low Risk,0,19,19,15
10/6/2020,High Risk,307,426,119,125
9/30/2020,Low Risk,282,288,6,6
10/10/2020,High Risk,30,410,380,512
3/4/2020,High Risk,41,575,534,121
10/4/2020,Low Risk,18,79,61,5
9/30/2020,Low Risk,155,198,43,40
9/19/2020,High Risk,80,194,114,153
9/26/2020,High Risk,210,318,108,98
10/18/2020,Low Risk,215,227,12,7
9/14/2020,Low Risk,34,78,44,8
7/22/2020,High Risk,230,397,167,305
8/24/2020,Low Risk,270,340,70,70
9/30/2020,Low Risk,287,315,28,18
10/16/2020,Low Risk,246,278,32,21
10/18/2020,Low Risk,10,82,72,19
10/13/2020,Low Risk,0,16,16,8
10/16/2020,Low Risk,169,222,53,51
10/5/2020,Low Risk,0,59,59,5
10/25/2020,Low Risk,0,22,22,10
9/13/2020,Low Risk,282,302,20,20
10/15/2020,Low Risk,42,57,15,27
10/7/2020,Low Risk,37,107,70,7
10/5/2020,High Risk,-1,304,305,295
10/5/2020,Low Risk,418,518,100,97
10/3/2020,Low Risk,0,31,31,22
10/18/2020,High Risk,144,234,90,107
11/1/2020,Low Risk,0,109,109,4
9/11/2020,Low Risk,288,348,60,15
10/22/2020,Low Risk,40,81,41,10
10/21/2020,Low Risk,6,50,44,12
10/20/2020,High Risk,142,408,266,255
9/29/2020,Low Risk,170,225,55,16
6/22/2020,Low Risk,0,158,158,10
10/21/2020,Low Risk,59,85,26,15
9/20/2020,Low Risk,39,93,54,8
10/21/2020,Low Risk,0,23,23,8
10/9/2020,Low Risk,252,291,39,8
7/11/2020,Low Risk,273,368,95,74
11/6/2020,High Risk,-1,272,273,263
10/29/2020,Low Risk,61,81,20,4
11/3/2020,Low Risk,225,351,126,109
10/27/2020,High Risk,48,248,200,192
10/22/2020,Low Risk,59,92,33,8
11/4/2020,Low Risk,204,294,90,19
11/8/2020,High Risk,298,341,43,42
11/4/2020,Legal Case,321,364,43,572
11/9/2020,Low Risk,245,282,37,12
11/8/2020,High Risk,19,151,132,92
10/16/2020,Low Risk,1,49,48,23
11/5/2020,High Risk,140,209,69,66
10/29/2020,Low Risk,328,343,15,15
11/2/2020,Low Risk,0,63,63,12
9/4/2020,Low Risk,168,250,82,77
10/29/2020,Low Risk,166,174,8,8
11/22/2020,Low Risk,44,81,37,9
11/20/2020,Low Risk,0,12,12,8
11/26/2020,Low Risk,219,272,53,12
11/20/2020,Low Risk,139,166,27,14
11/21/2020,Low Risk,126,139,13,4
11/14/2020,High Risk,37,390,353,378
11/16/2020,Low Risk,66,144,78,53
11/11/2020,Low Risk,114,161,47,48
11/27/2020,Low Risk,239,249,10,10
11/12/2020,Low Risk,132,165,33,6
11/2/2020,Low Risk,233,259,26,26
11/20/2020,Low Risk,0,74,74,10
11/13/2020,High Risk,56,125,69,82
11/20/2020,Low Risk,214,241,27,12
11/7/2020,Low Risk,252,298,46,7
11/22/2020,Low Risk,245,276,31,10
10/30/2020,Low Risk,42,83,41,10
8/3/2020,High Risk,69,310,241,161
11/25/2020,Low Risk,264,306,42,42
11/25/2020,Low Risk,86,170,84,79
11/13/2020,Low Risk,52,87,35,12
11/26/2020,High Risk,192,237,45,33
11/25/2020,Low Risk,344,393,49,20
11/10/2020,Low Risk,257,267,10,10
11/21/2020,High Risk,87,299,212,195
12/10/2020,Low Risk,0,39,39,4
12/3/2020,Low Risk,105,160,55,7
10/23/2020,Low Risk,0,60,60,21
9/11/2020,High Risk,57,699,642,74
9/14/2020,Low Risk,220,350,130,25
10/3/2020,Low Risk,59,173,114,8
10/19/2020,Low Risk,28,156,128,17
12/9/2020,Low Risk,271,320,49,23
12/8/2020,Low Risk,242,251,9,9
11/19/2020,Low Risk,201,211,10,10
11/30/2020,Low Risk,151,159,8,8
12/7/2020,Low Risk,230,288,58,58
11/9/2020,High Risk,78,275,197,188
12/7/2020,Low Risk,9,58,49,7
11/7/2020,High Risk,514,523,9,295
11/13/2020,Low Risk,266,291,25,25
11/22/2020,Low Risk,99,171,72,4
12/10/2020,High Risk,311,373,62,71
12/14/2020,High Risk,33,127,94,95
12/14/2020,Low Risk,120,170,50,50
12/23/2020,Low Risk,234,243,9,9
11/10/2020,Low Risk,149,365,216,216
12/15/2020,Low Risk,0,27,27,8
12/12/2020,Low Risk,146,191,45,28
11/19/2020,Low Risk,14,68,54,20
9/19/2020,Low Risk,98,221,123,9
11/5/2020,Low Risk,91,167,76,36
12/13/2019,Low Risk,928,951,23,23
12/21/2020,Low Risk,207,246,39,15
12/24/2020,High Risk,394,470,76,261
12/30/2020,Low Risk,0,26,26,16
12/26/2020,Low Risk,94,163,69,28
11/20/2020,Low Risk,104,171,67,63
1/6/2021,Low Risk,71,97,26,23
12/5/2020,Low Risk,197,257,60,18
12/24/2020,Low Risk,0,25,25,6
1/4/2021,Low Risk,0,14,14,5
12/3/2020,High Risk,99,245,146,153
1/9/2021,Low Risk,206,230,24,14
12/21/2020,High Risk,-21,324,345,320
1/8/2021,Low Risk,7,48,41,8
1/13/2021,Low Risk,66,76,10,10
1/14/2021,Low Risk,9,13,4,4
12/3/2020,Low Risk,0,89,89,4
1/9/2021,Low Risk,56,157,101,9
12/18/2020,High Risk,78,257,179,152
1/5/2021,Low Risk,524,552,28,28
1/3/2021,Low Risk,234,240,6,6
1/7/2021,Low Risk,40,69,29,15
12/31/2020,High Risk,81,372,291,247
1/21/2021,Low Risk,12,39,27,9
1/12/2021,High Risk,135,246,111,216
11/13/2020,High Risk,497,537,40,58
1/24/2021,Low Risk,0,31,31,10
1/24/2021,Low Risk,250,295,45,10
1/22/2021,Low Risk,217,249,32,19
1/17/2021,High Risk,97,264,167,173
1/27/2021,Low Risk,19,89,70,12
1/21/2021,Low Risk,0,30,30,14
2/10/2021,Low Risk,46,82,36,5
2/2/2021,Low Risk,266,286,20,7
1/24/2021,Low Risk,0,30,30,9
1/27/2021,Low Risk,0,33,33,13
2/14/2021,Low Risk,39,72,33,9
2/1/2021,Low Risk,157,190,33,33
1/31/2021,Low Risk,59,113,54,17
2/5/2021,High Risk,-43,312,355,172
2/18/2021,High Risk,-35,256,291,118
2/4/2021,Low Risk,111,174,63,8
12/29/2020,High Risk,33,287,254,246
2/9/2021,Low Risk,0,45,45,13
2/10/2021,Low Risk,199,222,23,23
2/16/2021,High Risk,178,503,325,82
2/17/2021,Low Risk,0,15,15,13
2/5/2021,Low Risk,0,35,35,6
2/19/2021,Low Risk,67,185,118,27
2/23/2021,High Risk,103,260,157,152
2/3/2021,Low Risk,0,33,33,11
1/20/2021,High Risk,141,414,273,14
10/12/2020,Low Risk,134,197,63,62
2/23/2021,High Risk,270,274,4,43
1/28/2021,High Risk,78,294,216,181
3/7/2021,Low Risk,181,234,53,45
3/9/2021,Low Risk,0,31,31,29
2/19/2021,High Risk,160,201,41,40
2/4/2021,High Risk,401,447,46,55
2/19/2021,Low Risk,118,159,41,6
2/25/2021,Low Risk,45,105,60,4
2/23/2021,Low Risk,57,115,58,15
2/20/2021,Low Risk,166,206,40,34
2/16/2021,High Risk,174,295,121,24
3/13/2021,Low Risk,41,86,45,8
3/5/2021,High Risk,117,167,50,49
2/21/2021,Low Risk,148,187,39,11
2/22/2021,Low Risk,115,123,8,8
3/2/2021,High Risk,87,240,153,147
3/11/2021,Low Risk,144,180,36,21
3/9/2021,Low Risk,127,184,57,28
3/5/2021,Low Risk,77,102,25,5
3/21/2021,Low Risk,0,211,211,7
3/22/2021,Low Risk,0,122,122,19
3/15/2021,High Risk,216,254,38,40
3/11/2021,Low Risk,137,188,51,46
3/16/2021,High Risk,-70,218,288,318
3/9/2021,Low Risk,34,65,31,22
3/24/2021,Low Risk,125,250,125,7
3/4/2021,High Risk,113,293,180,173
3/11/2021,High Risk,-4,228,232,117
3/29/2021,Low Risk,181,189,8,8
3/19/2021,Low Risk,215,241,26,12
3/7/2021,Low Risk,197,205,8,8
3/18/2021,High Risk,72,182,110,106
3/20/2021,Low Risk,363,515,152,152
3/24/2021,Low Risk,11,27,16,8
3/20/2021,Low Risk,33,101,68,7
3/19/2021,Low Risk,39,67,28,8
3/9/2021,Low Risk,6,72,66,13
3/29/2021,Low Risk,162,212,50,18
4/8/2021,High Risk,137,221,84,81
3/29/2021,Low Risk,15,59,44,5
3/31/2021,High Risk,63,239,176,171
3/24/2021,Low Risk,194,208,14,14
4/15/2021,High Risk,58,197,139,136
3/28/2021,Low Risk,91,135,44,11
1/17/2021,Low Risk,96,106,10,10
4/16/2021,Low Risk,207,215,8,8
3/26/2021,High Risk,28,125,97,94
3/29/2021,Low Risk,418,424,6,6
12/30/2020,Low Risk,95,243,148,10
2/17/2021,Low Risk,35,141,106,20
4/1/2021,Low Risk,145,267,122,122
3/29/2021,Low Risk,80,129,49,14
3/24/2021,Low Risk,142,196,54,8
1/29/2021,Legal Case,14,139,125,146
3/16/2021,Low Risk,109,157,48,8
3/13/2021,High Risk,328,389,61,143
3/23/2021,Low Risk,102,175,73,14
11/3/2020,Low Risk,1,205,204,21
4/21/2021,Low Risk,266,281,15,12
4/12/2021,Low Risk,72,102,30,4
4/16/2021,High Risk,110,179,69,67
4/5/2021,Low Risk,25,60,35,28
3/14/2021,High Risk,73,179,106,103
4/21/2021,High Risk,135,168,33,33
3/31/2021,Low Risk,42,152,110,14
5/6/2021,High Risk,149,251,102,97
5/6/2021,High Risk,45,168,123,121
5/13/2021,High Risk,29,82,53,52
5/8/2021,Low Risk,193,205,12,12
4/29/2021,High Risk,184,314,130,63
5/8/2021,Low Risk,406,429,23,23
5/18/2021,High Risk,-18,178,196,10
4/27/2021,High Risk,185,279,94,82
5/21/2021,Low Risk,0,102,102,5
5/25/2021,High Risk,91,181,90,33
5/31/2021,Low Risk,146,163,17,17
5/20/2021,High Risk,245,390,145,111
5/28/2021,Low Risk,23,63,40,10
6/13/2021,Low Risk,12,64,52,9
4/8/2021,High Risk,148,419,271,30
6/17/2021,High Risk,143,252,109,106
6/19/2021,Low Risk,0,74,74,4
6/9/2021,Low Risk,168,189,21,15
5/26/2021,Low Risk,11,65,54,15
6/21/2021,Low Risk,213,236,23,5
6/17/2021,Low Risk,215,235,20,20
6/22/2021,High Risk,195,251,56,21
7/16/2021,Low Risk,114,126,12,12
7/20/2021,Low Risk,113,168,55,25
7/19/2021,Low Risk,48,91,43,23
7/14/2021,Low Risk,249,297,48,11
7/7/2021,High Risk,183,315,132,128
7/10/2021,High Risk,104,151,47,40
8/5/2021,Low Risk,71,92,21,8
7/28/2021,Low Risk,182,194,12,12
8/6/2021,Low Risk,163,185,22,22
8/9/2021,High Risk,70,276,206,198
8/4/2021,Low Risk,0,70,70,22
8/4/2021,High Risk,97,169,72,42
7/30/2021,High Risk,135,166,31,37
8/5/2021,High Risk,12,305,293,294
8/2/2021,Low Risk,204,211,7,7
8/18/2021,Low Risk,235,262,27,10
8/13/2021,High Risk,121,138,17,17
8/20/2021,Low Risk,77,95,18,17
8/25/2021,High Risk,89,156,67,64
8/8/2021,Low Risk,187,198,11,11
8/24/2021,Low Risk,0,15,15,5
8/31/2021,Low Risk,0,15,15,9
7/4/2021,Low Risk,65,172,107,21
8/6/2021,Low Risk,19,101,82,15
8/1/2021,Low Risk,0,114,114,13
9/9/2021,High Risk,32,68,36,32
7/20/2021,Low Risk,205,211,6,6
8/30/2021,High Risk,119,172,53,58
8/26/2021,Low Risk,80,105,25,25
8/23/2021,Low Risk,182,199,17,17
9/4/2021,Low Risk,148,167,19,18
8/20/2021,Low Risk,30,77,47,30
9/21/2021,Low Risk,122,143,21,9
10/2/2021,High Risk,151,300,149,143
10/6/2021,High Risk,216,254,38,37
10/3/2021,High Risk,95,173,78,77
4/9/2021,Low Risk,143,202,59,55
9/21/2021,High Risk,234,247,13,11
10/6/2021,Low Risk,86,170,84,9
3/5/2021,Low Risk,142,151,9,39
9/20/2021,Low Risk,36,101,65,19
9/6/2021,Low Risk,0,78,78,10
10/19/2021,Low Risk,4,14,10,6
10/23/2021,Low Risk,32,52,20,9
10/18/2021,Low Risk,80,95,15,15
10/15/2021,Low Risk,0,52,52,29
11/7/2021,Low Risk,0,17,17,14
11/15/2021,Low Risk,0,52,52,6
11/12/2021,Low Risk,6,61,55,9
